#General
Delete=Borrar
Save=Guardar
Settings=Configuración
Setup=Configuración
Enabled=Activado
kWh=kWh

#Akku Trips.json
Akku Trips=Trayectos entre Cargas
Start Trip=Iniciar Viaje
End Trip=Finalizar Viaje
Time=Fecha
StartSOC=SoC inicial
EndSOC=SoC final
SOC diff=Diferencia de SoC
Start km=Kms iniciales
End km=Kms finales
Start mi=Millas iniciales
End mi=Millas finales
kmDiff=Dif. de kms
Max Range=Autonomía máx.
Ø Verbrauch=Consumo medio
Tage=Días

#Degradation.json
Degradation=Degradación
Maximalreichweite [km]=Autonomía máx. [km]
Maximalreichweite [mi]=Autonomía máx. [mi]
km Stand [km]=Odómetro [km]
mi Stand [mi]=Odómetro [mi]
Odometer [mi]=
Max. Reichweite (Monatsmittel) [km]=Autonomía máx. (media mensual) [km]
Max. Reichweite (Monatsmittel) [mi]=Autonomía máx. (media mensual) [mi]

#Ladehistorie.json
Ladehistorie=Historial de Cargas
Startdatum=Fecha de Inicio
Enddatum=Fecha de Fin
geladen kWh=kWh Cargados
km Stand=Odómetro
Adresse=Dirección
TR km Start=Aut.Estim.Inicio [km]
TR km Ende=Aut. Estim.Fin [km]
SOC Ende=SoC Final
100% TR=Aut.Estim. 100%
Minuten=Minutos
TR mi Start=Aut.Estim. Inicio [mi]
TR mi Ende=Aut. Estim. Fin [mi]
ØkW=Media kW

#Ladestatistik.json
Ladestatistik=Estadísticas de Carga
Letzte Ladung=Última Carga
Ort=Dirección
Ø geladen kWh=Media de kWh cargados
Ladezeit h=Duración de la carga (h)
Ø SOC=SoC Medio
Max SOC=SoC Máximo
Anzahl Ladungen=Número de cargas
Anzahl=Cuenta
Geladen=Cargado
Ladezeit=Tiempo de Carga
Anz. Ladungen=Cuenta
Ladehub=% Carga

#SOC Ladestatistik.json
SOC Ladestatistik=Estadísticas de carga - SoC
SOC [%]=SoC [%]

#Laden.json
Laden=Cargando
Ladespannung [V]=Voltaje de Carga [V]
Reichweite [mi]=Autonomía [mi]
Reichweite [km]=Autonomía[km]
Leistung [kW]=Potencia [kW]
Phasen=Fases
Stromstärke [A]=Intensidad [A]
Angefordert [A]=Int. solicitada [A]
Pilot [A]=Int.Cargador [A]

#Vampir Drain Monatsstatistik.json
Vampir Drain Monatsstatistik=Estadísticas Mensuales de Consumo Fantasma
TR mi Verlust=Aut.Estim. Perdida [mi]
kWh Verlust=kWh Perdidos
Eur Verlust=Euros Perdidos
Zeitspanne Stunden=Periodo (horas)
TR mi Verlust pro Stunde=Aut.Estim.Perdida por hora [mi]
mi Stand=Odómetro

#Trip.json
Trip=Viaje
Start=Inicio
Ende=Fin
Start Adresse=Dirección de Inicio
Ziel Adresse=Dirección de Destino
Ø Verbrauch kWh=Consumo medio (kWh)
Verbraucht kWh=kWh Consumidos
Dauer Min=Duración (min)
mi=mi
km=km
Ø °C=°C medios
Ø °F=°F medios
max mph=Máx mph
max km/h=Máx km/h
max PS=Cv Máx
min PS=Cv Mín
max kW=kW Máx
min kW=kW Mín
Ø PS=Cv. medios
Ø kW=kW medios
Ø mph=mph medias
Ø km/h=Km/h medios

#Vampir Drain.json
Vampir Drain=Consumo Fantasma
Standby Stunden=Horas en Espera
Standby=En Espera
TR km Verlust=Aut.Estim.Perdida [km]
TR km Verlust pro Stunde=Aut.Estim.Perdida por hora [km]

#Verbrauch.json
Verbrauch=Consumo
Höhe [m]=Altitud [m]
Altitude [m]=Altitud [m]
Geschwindigkeit [mph]=Velocidad [mph]
Geschwindigkeit [km/h]=Velocidad[km/h]
Leistung [PS]=Potencia [Cv]
Außentemperatur [°C]=Temperatura Exterior [°C]
Außentemperatur [°F]=Temperatura Exterior [°F]
Innentemperatur [°C]=Temperatura Interior [°C]
Innentemperatur [°F]=Temperatura Interior [°F]

Laden fertig=Carga Terminada
Schlafen=Durmiendo
Online=Online

#Visited.json
Visited=Visitado

#index.php
Car Info=Información del coche
Status=Estado
Typical Range=Autonomía típica
Odometer=Odómetro
Car Version=Versión del coche
Last Trip=Último Viaje
Duration=Duración
Distance=Distancia
Max km/h=Km/h máximos
PS=Cv
Current Pos=Pos. Actual
Last Update=Última actualización
Charging=Cargando
Done=Hecho
Done at=Hecho a
Battery Heater=Acondicionador de batería
Sentry Mode=Modo Centinela
Preconditioning=Preacondicionando
Offline=Offline
Falling asleep=Intentando dormir
min=min
Wh/km=Wh/km
km/h=km/h
Sleeping=Para dormir
kW=kW
OK=OK
No=No
Yes=Sí
Cell Temp=Temperatura de la célula
Max Charge=Carga máxima
Max Discharge=Descarga máxima
Cell Imbalance=Desequilibrio celular
Software Update=Actualización de software
Consumption=Consumo
Ø Consumption=Ø Consumo
Please update to latest docker-compose.yml file. Check: {LINK}=Por favor, actualice a la última docker-compose.yml archivo. Compruébelo: {LINK}

#menu.php
Logfile=Fichero de log
Restart=Reiniciar
Update=Actualizar
Dashboards=Dashboards
Fleet Statistic=Estadísticas de Flota
Extras=Extras
Backup=Backup
Restore=Restaurar
Geofence=Geoperimetraje
Suspend Teslalogger=Suspender Teslalogger
Wakeup Teslalogger=Despertar a Teslalogger
Dashboard=Dashboard
My Degradation=Mi degradación
My Charging AVG=Mi carga AVG
Fleet Degradation AVG=Degradación de la flota AVG
Fleet Charging AVG=Carga de la flota AVG
Fleet Charging MAX (Firmware)=Fleet Charging MAX (Firmware)
Fleet Charging Locations=Puntos de recarga de flotas
Fleet Fast Charging Map=Mapa de recarga rápida de la flota
Supercharger Usage=Uso del sobrealimentador
Firmware Tracker=Rastreador de firmware
Abetterrouteplanner=Planificador de rutas

#password.php
Teslalogger Tesla Credentials=Teslalogger Credenciales Tesla
Please enter your Tesla account credentials=Por favor, introduce tus credenciales de Tesla
Email=Email
Password=Contraseña
Repeat Password=Repite Contraseña
Speichern=Guardar
Please enter the access token!=Por favor, introduzca el código de acceso.
Please enter the refresh token!=Por favor, introduzca el token de actualización.
Please select a vehicle=Seleccione un vehículo
Check Logfile!=Compruebe el archivo de registro.
Do you really want to delete this vehicle?=¿De verdad quieres eliminar este vehículo?
Check Logfile in one minute!=Compruebe el archivo de registro en un minuto
Unauthorized=Sin autorización
This isn't a valid URL!=Esta URL no es válida.
This isn't an auth link by Tesla!=¡Esto no es un enlace auth por Tesla!
The URL doesn't contain the expected format!=¡La URL no contiene el formato esperado!
TeslaAuthApps=Puede utilizar las siguientes aplicaciones para obtener un token de acceso y un token de actualización del servidor Tesla:
BA_Browser=En el {navegador} local (recomendado)
BA_Read=Por favor, lea todos los pasos antes de continuar:
BA_Logon=Haga clic en el siguiente enlace titulado <b>Inicio de sesión de Tesla</b> que abrirá una nueva pestaña/ventana para la página de inicio de sesión de autenticación de Tesla.
BA_Auth=Inicie sesión con sus credenciales de Tesla y MFA si es necesario (Tesla los recordará si ha utilizado el enlace anteriormente).
BA_NotFound=Aparecerá el mensaje "Página no encontrada". Esto es normal.
BA_URL=Copie la URL resultante de esa página web en el siguiente formulario. Dentro de la URL hay un código temporal que podemos utilizar para generar tokens. Lo extraeremos del enlace.
BA_Invalid=Estos enlaces normalmente sólo funcionan una vez, por lo que si aparece un mensaje de error "Concesión no válida" o de otro tipo en nuestro sitio web, es posible que tenga que empezar de nuevo con el enlace Tesla Logon, que debería producir un nuevo enlace.
BA_Logoff=Si quieres utilizar una cuenta diferente, tienes que desconectarte manualmente {aquí}.
BA_GetToken=Entonces obtendremos los tokens para tu cuenta Tesla.
BA_SelectCar=Seleccione el coche que desea utilizar para Teslalogger.
BA_Step1=Paso 1:
BA_Step2=Paso 2:
BA_Step3=Paso 3:
BA_FillOut=Rellene este formulario:
BA_CopyUrl=Copie la url resultante como se muestra
BA_Paste=Pegue la url resultante en la casilla y haga clic en el botón "Obtener fichas":
Get Tokens=Obtener fichas
Access Token=Ficha de acceso
Refresh Token=Actualizar ficha
Car=Coche
Free Supercharging=Supercarga gratuita
Reconnect=Vuelva a conectar
Please choose your vehicle=Elija su vehículo
Model=Modelo
VIN=VIN
Free SUC=SUC gratuito
Edit=Editar
New car=Coche nuevo

#settings.php
Credentials=Credenciales
Language=Idioma
Power=Potencia
Temperatur=Temperatura
Unit of length=Unidad de longitud
URL Admin Panel=URL Panel Admin
All=Todas
Stable=Estable
None=Ninguna
Enable=Activar
Celsius=Celsius
Fahrenheit=Fahrenheit
URL Grafana=URL Grafana
Teslalogger HTTP Port=Puerto HTTP Teslalogger
Zoom Level=Nivel de Zoom
ScanMyTesla integration=Integración ScanMyTesla
Main Car=Coche Principal
Car Name=Nombre del Coche
ScanMyTesla last received=ScanMyTesla última recepción
Tasker Token=Token Tasker
Tasker URL=URL Tasker
Received Tasker Token=Tasker Token Recibido
Saved!=¡Salvado!
MyTesla=MyTesla
Teslalogger Adminpanel=Panel de administración de Teslalogger
Temperature=Temperatura
mile=milla
Ideal=Ideal
Rated=Rated
Share data anonymously=Compartir datos de forma anónima
Sleep=Dormir
to=a
Show calc. 100% range=Mostrar calc. Rango 100%
Position by StreamingAPI=Posición por StreamingAPI

#Alle Verbräuche - ScanMyTesla.json
Alle Verbräuche - ScanMyTesla=Todos los consumos - ScanMyTesla
Zelltemperatur [°C]=Temperatura de Celdas [°C]
Zelltemperatur [°F]=Temperatura de Celdas [°F]

#Trip Monatsstatistik.json
Datum=Fecha
Fahrzeit [h]=Tiempo de Conducción [h]
Strecke [km]=Distancia [km]
Strecke [mi]=Distancia [mi]
Verbraucht [kWh]=kWh Consumidos
Ø Verbrauch [kWh]=kWh Medios Consumidos
Anzahl Trips=Número de viajes
Trip Monatsstatistik=Estadísticas Mensuales de Viajes

Zellspannungen 01-20 - ScanMyTesla=Voltajes de Celdas 01-20 - ScanMyTesla
Zellspannungen 21-40 - ScanMyTesla=Voltajes de Celdas 21-40 - ScanMyTesla
Zellspannungen 41-60 - ScanMyTesla=Voltajes de Celdas 41-60 - ScanMyTesla
Zellspannungen 61-80 - ScanMyTesla=Voltajes de Celdas 61-80 - ScanMyTesla
Zellspannungen 81-99 - ScanMyTesla=Voltajes de Celdas 81-99 - ScanMyTesla

Ja=Sí
Nein=No

Einschlafen=Intentando dormir
Automatic updates=Actualizaciones automáticas

TextShare=<h1>Comparte curvas de carga / degracación de forma anónima</h1>Nos gustaría crear una base de datos anónima para comparar curvas de degradación y carga. Esto permite comparar tu vehículo con otros en cualquier momento y detectar cualquier desviación anómala de forma prematura. Esto también se puede usar más adelante para probar que tu batería aún es plenamente eficiente a la hora de vender el vehículo. En caso contrario, puedes probar un peor rendimiento a Tesla Motors.<br><br>¿Querrías compartir tus curvas de carga rápida y degradación con otros conductores de Tesla de forma completamente anónima? Esta decisión se puede cambiar en cualquier momento en la pantalla de configuración.
StreamingPosHelp=<h1>Posición por StreamingAPI</h1>permite entradas en la base de datos de posiciones desde la API de streaming - dependiendo de la recepción del coche esto significa hasta 5 posiciones por segundo (comparado con una posición cada cinco segundos en modo normal), esto aumentará mucho el tamaño de tu base de datos, aumentará el desgaste de la tarjeta SD y resultará en enormes copias de seguridad.
Daten anonym teilen=Compartir datos de forma anónima
TextSuspendTeslalogger=¡Teslalogger se ha detenido! ¡No se registrarán datos!
Resume Teslalogger=Rearrancar Teslalogger
Range=Autonomía

#Timeline Plugin.json
Parking=Aparcando
Driving=Conduciendo
Missing=Perdiendo
Ø Temperatur=Ø Temperatura

#abrp.php
ABRPTitle=Enlace Abetterouteplanner
TextABRP=Puede configurar un enlace de Teslalogger a Abetterouteplanner para evitar dar sus credenciales de Tesla a un tercero. Otro beneficio es minimizar la posibilidad de evitar que el auto se quede dormido si más de un servicio está usando sus credenciales.
ABRP1=Crear una cuenta Abetterouteplanner
ABRP2=Ir a Configuración
ABRP3=Elige tu coche
ABRP4=Guarda tu coche en tu cuenta
ABRP5=Dale un nombre a tu auto
ABRP6=Haga clic en "Enlace genérico" para obtener un token ABRP
ABRP7=Copie el token y haga clic en "Listo"
ABRP8=Insertar el token en Teslalogger
ABRP9=Verificar si el Teslalogger está conectado
ABRPYT=Consulte el tutorial de YouTube para una demostración en vivo
ABRPToken=Token Abetterouteplanner

#chargingcost.php
Charging Costs=Costes de Carga
Charged=Cargado
Charger=Estación de Carga
Efficiency=Eficiencia
Currency=Divisa
kWh according to meter/invoice=kWh según contador/factura
Cost per kWh=Coste por kWh
Cost per charge=Coste por carga
Cost per minute=Coste por minuto
Idle cost per minute=Coste de inactividad por minuto
Total=Total
Date=Fecha
Minutes=Acta

#wallbox.php
Wallbox=Wallbox
WallboxComment=Puedes conectar tu Teslalogger a tu Wallbox para calcular la eficiencia de la carga o el porcentaje de energía fotovoltaica utilizada para cargar tu coche.
Host=Host
Param=Param
Test=Prueba
Type=Tipo
Info=Info
Version=Versión
Utility kWh=Utility kWh
Vehicle kWh=Vehículo kWh

#superchargebingo.php
SuperChargeBingo=SuperChargeBingo
SuperChargeBingoComment=Puede configurar un enlace desde TeslaLogger a SuperChargeBingo para realizar registros automáticos en los Supercargadores.
Create a SuperChargeBingo account=Crear una cuenta SuperChargeBingo
Create API key (must be secure)=Crear clave API (debe ser segura)
Copy Username and API key and insert it in TeslaLogger=Copiar nombre de usuario y la clave de API e insertarlo en TeslaLogger
Save and restart TeslaLogger=Guardar y reiniciar TeslaLogger
Username=Nombre de usuario
API key=Clave API

#geoadd.php
Name & Position=Nombre
Description=Descripción
Radius=Radio
Special Flags=Banderas especiales
Home=Inicio
Work=Trabajo
Copy Charging Costs=Costes del canon por copia
Don't Combine Charging Sessions=No combine sesiones de carga
Set Charge Limit=Fijar límite de carga
SOC=SOC
Set on arrival=Set a la llegada
Set Charge Limit After Charging=Establecer límite de carga después de la carga
Open Charge Port=Puerto de carga abierto
Gear=Engranaje
D → P=D → P
D/R → P=D/R → P
R → P=R → P
High Frequency Logging=Registro de alta frecuencia
Special Count=Recuento especial
Count=Cuenta
Special Features=Características especiales
Enable Sentry Mode=Activar el modo centinela
Disable Sentry Mode=Desactivar el modo centinela
Turn HVAC off=Apagar HVAC
No sleep=No dormir
Are you sure you want to delete this geofencing location?=¿Está seguro de que desea eliminar esta ubicación de geovalla?
Error=Error
Deleted!=¡Borrado!
Meter=Metro

#journeys.php
Journeys=Viajes
Journey name missing!=Falta el nombre del viaje
Please select=Seleccione una opción
Please select start point!=Seleccione el punto de partida.
Please select end point!=Seleccione el punto final.
TextJourneys=Puede utilizar viajes para combinar un viaje largo / tiempo y resumir todos los números. Esto es muy útil para realizar un seguimiento del tiempo de carga completa de un viaje largo o para comparar el consumo de los neumáticos de verano o de invierno.
ID=ID
Journey=Viaje
Start address=Dirección de inicio
Target address=Dirección de destino
End=Fin
Consumed kWh=kWh consumidos
Charged kWh=kWh cargados
Drive time [h]=Tiempo de conducción [h]
Charge time [h]=Tiempo de carga [h]
Distance [mi]=Distancia [mi]
Distance [km]=Distancia [km]
Charging costs=Gastos de cobro
CO2 [kg]=CO2 [kg]
New Journey=Nuevo viaje
Journey name=Nombre del viaje
Please wait=Espere, por favor
Please select start first=Seleccione primero el inicio
DelJourney=¿Realmente quieres borrar el viaje {id}?
Display _MENU_ records per page=Mostrar _MENU_ registros por página
Nothing found=No se ha encontrado nada
Showing _START_ to _END_ of _TOTAL_ entries=Mostrando de _START_ a _END_ de _TOTAL_ entradas
No records available=No hay registros disponibles
(filtered from _MAX_ total records)=(filtrado a partir de _MAX_ registros totales)
Search=Buscar en
First=En primer lugar
Last=Última
Next=Siguiente
Previous=Anterior

#adminpanelpassword.php
Please enter password!=Por favor, introduzca la contraseña.
Passwords do not match!=Las contraseñas no coinciden.
Do you want to delete your password?=¿Desea eliminar su contraseña?
Set password for Teslalogger's admin panel=Establecer contraseña para el panel de administración de Teslalogger
Name=Nombre

#changelog.php
Changelog=Registro de cambios

#logfile.php
Download Logfile=Descargar archivo de registro
Lines=Líneas
Housekeeping=Limpieza
Sleep Attempt=Intento de sueño

#ovms.php
Please enter your dexters-web.de account credentials=Introduzca las credenciales de su cuenta de dexters-web.de
Dexter Login=Inicio de sesión de Dexter
Dexter Password=Contraseña Dexter

#password_info.php
Credentials Info=Información sobre credenciales

#restore.php
Restore Database=Restaurar base de datos
TextRestore1=Por favor, asegúrese de hacer una copia de seguridad de su Teslalogger antes de restaurar cualquier base de datos. ¡Mueva la carpeta de copia de seguridad de \\RASPBERRY\teslalogger\backup a su disco duro!
TextRestore2=El proceso de restauración puede durar hasta 10 minutos.
TextRestore3=No interrumpas de ninguna manera el proceso de restauración. No recargues la página. No cierres la página.
