#Info
INFO_important="Önemli Duyuru"
INFO_FLEETAPI="Tesla, 01.01.2025 tarihinden itibaren resmi Fleet API'sini ücretli bir modele dönüştürdü. ({LINK1}). Bu nedenle, Tesla'ya, vergilere ve ödeme hizmeti sağlayıcısına olan giderlerimi karşılamak için abonelik modeline geçmek ve aylık küçük bir ücret talep etmek zorundayım.<br/><br/>Aynı zamanda, Tesla'nın Kullanım Şartları ({LINK2})beni gayri resmi Owners API'sini kullanmayı bırakmaya zorluyor, aksi takdirde Tesla bana karşı yasal işlem başlatabilir (Madde 5.6.6 ve 5.6.11). Lütfen araçlarınızı Owners API'den Fleet API'ye geçirin ve bunu yapmak için giriş bilgilerinizi yeniden girin.<br/><br/>Ne yazık ki, eski Model S/X'ler (2021 öncesi üretim) için Fleet API kullanımına yönelik bir çözüm bulunmamaktadır. Bu araçlar eski Owners API üzerinden çalıştırılmaya devam edilebilir. Tesla'nın bu durumlarda yasal işlem başlatmayacağını varsayıyorum. Bu araçlar için yine de abonelik satın alabilirsiniz, ancak bu daha çok gönüllü bir bağış olarak anlaşılmalıdır, çünkü bunun için Tesla'ya herhangi bir ücret ödemem gerekmiyor.<br/><br/>Tesla, Fleet API ile hem sunucularını rahatlatmak hem de gelir elde etmek istediğinden, gayri resmi Owners API'nin 01.01.2025 tarihinden sonra kapatılma olasılığı vardır. Umarız ki daha eski Model S/X'ler bundan etkilenmeyecektir."
INFO_RESTRICTED="Aktif bir abonelik olmadan, maalesef Tesla'nız için maliyetleri karşılayamıyoruz. Bu nedenle, işlevselliği ve özellikle konum güncellemelerinin sıklığını önemli ölçüde sınırlamak zorundayız."
INFO_VEHICLE_LOCATION="Tesla, veri erişimi üzerinde daha ayrıntılı kontrol sağladı: {LINK1} Üçüncü taraf uygulamalar, konum bilgilerine erişmek için izin isteyebilir. Henüz bu izni vermediniz. Mart 2025'ten itibaren, gerekli izni vermediğiniz sürece hiçbir konum bilgisi paylaşılmayacaktır. Lütfen tekrar giriş yapın: {LINK2}."

#Akku Trips.json
Akku Trips="Batarya Kullanımı (Sürüşte)"
Start Trip="Seyahati Başlat"
End Trip="Seyahati Bitir"
Time="Tarih"
StartSOC="Başlangıç Şarj Seviyesi"
EndSOC="Bitiş Şarj Seviyesi"
SOC diff="Şarj Seviyesi Farkı"
Start km="Başlangıç KM"
End km="Bitiş KM"
Start mi="Başlangıç Mil"
End mi="Bitiş Mil"
kmDiff="KM Fark"
Max Range="Maks. Menzil"
Ø Verbrauch="Ort. Tüketim"
Tage="Günler"
Save="Kaydet"

#Degradation.json
Degradation="Aşınma"
Maximalreichweite [km]="Maks. Menzil (Km)"
Maximalreichweite [mi]="Maks. Menzil (Mil)"
km Stand [km]="Sayaç [Km]"
mi Stand [mi]="Sayaç [Mil]"
Odometer [mi]="Kilometre Sayacı [Mil]"
Max. Reichweite (Monatsmittel) [km]="Maks Menzil (aylık ort) [Km]"
Max. Reichweite (Monatsmittel) [mi]="Maks Menzil (aylık ort) [Mil]"

#Ladehistorie.json
Ladehistorie="Şarj Geçmişi"
Startdatum="Başlangıç Tarihi"
Enddatum="Bitiş Tarihi"
geladen kWh="kWSa Şarj Edilen"
km Stand="Kilometre Sayacı"
Adresse="Adres"
TR km Start="Tipik Menzil Seyahat Başlangıç Km"
TR km Ende="Tipik Menzil Seyahat Bitiş Km"
SOC Ende="Şarj Seviyesi Bitiş"
100% TR="100% Tipik Menzil"
Minuten="Dakika"
TR mi Start="Seyahat Başlangıç Mil"
TR mi Ende="Seyahat Bitiş Mil"
ØkW="Ort. kW"

#Ladestatistik.json
Ladestatistik="Şarj İstatistikleri"
Letzte Ladung="Son şarj"
Ort="Adres"
Ø geladen kWh="Ort. şarj edilen kWSa"
Ladezeit h="Şarj Süresi sa"
Ø SOC="Ort. Şarj Seviyesi"
Max SOC="Maks. Şarj Seviyesi"
Anzahl Ladungen="Şarj Sayısı"
Anzahl="Sayı"
Geladen="Şarj edildi"
Ladezeit="Şarj süreci"
Anz. Ladungen="Şarj Sayısı"
Ladehub="Şarj Etme Menzili"
PV="Güneş Enerjisi"

#SOC Ladestatistik.json
SOC Ladestatistik="Şarj Seviyesi İstatistikler"
SOC [%]="Şarj Seviyesi [%]"

#SOC Entladestatistik.json
SOC Entladestatistik="Şarj Seviyesi Boşalma İstatistikleri"

#Laden.json
Laden="Şarj Oluyor"
Ladespannung [V]="Şarj Voltajı"
Reichweite [mi]="Menzil (Mil)"
Reichweite [km]="Menzil (km)"
Leistung [kW]="Şarj Gücü [kW]"
Phasen="Faz"
Stromstärke [A]="Akım [A]"
Angefordert [A]="İstenen [A]"
Pilot [A]="Pilot [A]"

#Vampir Drain Monatsstatistik.json
Vampir Drain Monatsstatistik="Aylık Vampir Kaybı İstatistikleri"
TR mi Verlust="Tipik Menzil mil Kaybı"
kWh Verlust="kWSa Kaybı"
Eur Verlust="EUR Kaybı"
Zeitspanne Stunden="Zaman aralığı Saat"
TR mi Verlust pro Stunde="Tipik Menzil Seyahat Saat`te mi Kaybı"
mi Stand="Kilometre Sayacı"

#Trip.json
Trip="Seyahat"
Start="Başlangıç"
Ende="Bitiş"
Start Adresse="Başlangıç Adresi"
Ziel Adresse="Hedef Adresi"
Ø Verbrauch kWh="Ort. Tüketim kWSa"
Verbraucht kWh="kWSa Tüketim"
Dauer Min="Süreç (dak.)"
mi="mil"
km="km"
Ø °C="Ort.°C"
Ø °F="Ort.°F"
max mph="maks Mph"
max km/h="maks Km/h"
max PS="maks BG"
min PS="min BG"
max kW="maks kW"
min kW="min kW"
Ø PS="Ort. BG"
Ø kW="Ort. kW"
Ø mph="Ort. Mph"
Ø km/h="Ort. Km/h"

#Trip Top Destinations.json
Trip Top Ziele="Sık Gidilen Hedef Noktalar"
Letzte Fahrt="Son Seyahat"
Ø Dauer Min="Ort. Süreç (dak.)"
Ø Verbrauch kWh/100km="Ort. Tüketim kWSa/100Km"
Ø Verbraucht kWh="Ort. Tüketim kWSa"
Anzahl Trips="Seyahat Sayısı"
Anzahl="Sayı"
Fahrzeug="Araç"

#Vampir Drain.json
Vampir Drain="Vampir Kaybı"
Standby Stunden="bekleme modundaki süreç"
Standby="bekleme modu"
TR km Verlust="Tipik Menzil Seyahat Km Kaybı"
TR km Verlust pro Stunde="Tipik Menzil Seyahat Saat`te Km Kaybı"

#Verbrauch.json
Verbrauch="Tüketim"
Höhe [m]="Yükseklik (m)"
Altitude [m]="Yükseklik (m)"
Geschwindigkeit [mph]="Hız [mi/sa]"
Geschwindigkeit [km/h]="Hız [km/sa]"
Leistung [PS]="Beygir Gücü [BG]"
Außentemperatur [°C]="Dış sıcaklık [°C]"
Außentemperatur [°F]="Dış sıcaklık [°F]"
Innentemperatur [°C]="İç sıcaklık [°C]"
Innentemperatur [°F]="İç sıcaklık [°F]"
Laden fertig="Şarj Bitti"
Schlafen="Uyku"
Online="Çevirimiçi"

#Verbrauchsstatistik.json
Verbrauchsstatistik="Tüketim İstatistikleri"

#Visited.json
Visited="Ziyaret edilen"

#index.php
Car Info="Araç Bilgileri"
Status="Statü"
Typical Range="Tipik Menzil"
Odometer="Kilometre Sayaçı"
Car Version="Araç Versiyonu"
Last Trip="Son Seyahat"
Duration="Süreç"
Distance="Mesafe"
Max km/h="Maks. Km/h"
PS="Beygir Gücü"
Current Pos="Konum"
Last Update="Son güncelleme"
Charging="Şarj Ediliyor"
Done="Bitti"
Done at="Bitiş Vakti"
Battery Heater="Batarya Isıtıcısı"
Sentry Mode="Sentrik Modus"
Preconditioning="Ön İklimlendirme"
Offline="Çevrim Dışı"
Inactive="Aktif Dışı"
Falling asleep="Uyku moduna geçiş"
min="Min"
kWh="kWSa"
Wh/km="WSa/Km"
km/h="Km/h"
Sleeping="Uyku modunda"
kW="kW"
OK="Ok"
No="Hayır"
Yes="Evet"
Cell Temp="Hücre Sıcaklığı"
Max Charge="Maks Şarj"
Max Discharge="Maks Deşarj"
Cell Imbalance="Hücre Dengesizliği"
Software Update="Yazılım Güncelleme"
Consumption="Tüketim"
Ø Consumption="Ort. Tüketim"
Please update to latest docker-compose.yml file. Check: {LINK}="Lütfen en son docker-compose.yml dosyasını güncelleyin. Kontrol edin:{LINK}"
FatalErrorMissingKey="Sanal Anahtar Eksik!<br>Kurulumu şu adreste tamamlayın: {LINK}<br>Ve Teslalogger'ı yeniden başlatın."

#menu.php
Logfile="Günlük Tutanağı"
Restart="Yeniden Başlat"
Update="Güncelleme"
Dashboards="Gösterge Tabloları"
Fleet Statistic="Filo İstatistikleri"
Extras="Ekstralar"
Settings="Ayarlar"
Backup="Yedekle"
Restore="İyileştirme"
Geofence="Geofence"
Suspend Teslalogger="Teslalogger'ı Askıya Al"
Wakeup Teslalogger="Teslalogger'ı uyandır"
Dashboard="Gösterge Tablosu"
My Degradation="Pil Aşınmam"
My Charging AVG="Şarj Ortalamam"
Fleet Degradation AVG="Ort. Filo Degratasyonu"
Fleet Charging AVG="Ort. Filo Şarj"
Fleet Charging MAX (Firmware)="Maks Filo Şarj (Yazılım)"
Fleet Charging Locations="Filo Şarj Konumları"
Fleet Fast Charging Map="Filo hızlı Şarj hartiası"
Supercharger Usage="SüperŞarj Kullanımı"
Firmware Tracker="Yazılım Takibi"
Abetterrouteplanner="Daha uygun rota planlayıcı"

#password.php
Teslalogger Tesla Credentials="Teslalogger Tesla bilgileri"
Please enter your Tesla account credentials="Lütfen Tesla Kullanıcı bilgilerinizi girin"
Email="e-posta adresiniz"
Password="Şifre"
Repeat Password="Şifreyi tekrarla"
Löschen="Sil"
Speichern="Kaydet"
Please enter the access token!="Lütfen 'Access Token' Erişim Token bilgilerinizi girin"
Please enter the refresh token!="Lütfen 'Refresh Token' Yenileme Token bilgilerinizi girin"
Please select a vehicle="Lütfen aracınızı seçin"
Check Logfile!="Tutanağı kontrol ediniz"
Do you really want to delete this vehicle?="Aracı silmek üzeresiniz, emin misiniz?"
Check Logfile in one minute!="Tutanağı bir dak. sonra tekrar kontrol ediniz"
Unauthorized="İzinsiz"
This isn't a valid URL!="Bu geçerli bir URL değil."
This isn't an auth link by Tesla!="Bu bir Tesla kimlik doğrulama bağlantısı değil!"
The URL doesn't contain the expected format!="URL beklenen formatta değil!"
Access Token="Erişim Tokeni"
Refresh Token="Yenileme Tokeni"
Car="Araç"
Free Supercharging="Ücretsiz SüperŞarj"
Reconnect="Tekrar bağlan"
Model="Model"
VIN="Şasi Numarası"
Free SUC="Ücretsiz Süper Şarj"
Edit="Düzenle"
New car="Yeni Araç"
TeslaAuthApps="Tesla Kimlik Doğrulama Uygulamaları"
BA_Browser="Tarayıcı"
BA_Read="Oku"
BA_Logon="Oturum Aç"
BA_Auth="Kimlik Doğrulama"
BA_NotFound="Bu, "_QQ_"Sayfa Bulunamadı"_QQ_" hatasına yol açacaktır. Bu normaldir."
BA_URL="Web sayfasının URL'sini aşağıya yapıştırın. Belirteçler (tokenler), içinde bulunan geçici bir koddan oluşturulacaktır."
BA_Invalid="Bu bağlantılar genellikle yalnızca bir kez çalışır, bu nedenle web sitemizde "_QQ_"Geçersiz Yetki"_QQ_" (Invalid Grant) veya başka bir hata mesajı görünürse, Tesla Giriş bağlantısını kullanarak işlemi en baştan başlatmanız ve yeni bir bağlantı almanız gerekebilir."
BA_Logoff="Oturumu Kapat"
BA_GetToken="Bundan sonra, Tesla hesabınız için belirteçler (tokenler) alınacaktır."
BA_SelectCar="Teslalogger ile kullanmak istediğiniz aracı seçin."
BA_Step1="Adım 1"
BA_Step2="Adım 2"
BA_Step3="Adım 3"
BA_FillOut="Doldur"
BA_CopyUrl="URL'yi Kopyala"
BA_Paste="Yapıştır"
BA_FLEETAPI="Filo API'si"
BA_ALLCARS="Tüm Araçlar"
BA_MODELSXOLD="Eski Model S/X"
Get Tokens="Tokenleri Al"
Subscription="Abonelik"
Subscribe="Abone Ol"
SubscribeManage="Aboneliği Yönet"
SubscriptionRequired="Abonelik Gerekli"
FleetAPIRequired="Filo API'si Gerekli"
Aktiv="Aktif"

#password_fleet.php
PF_LOGOUT="Çıkış"
PF_LOGIN="Giriş"
PF_LINK="Link"
PF_HELP="Yardım"
PF_PERMISSION="İzin"
PF_OLDSX="Eski S/X"
PF_HERE="Burada"
PF_VKEY="Doğrulama Anahtarı"
PF_SUBSCRIPTION="Abonelik"

#changecarname.php
CarNameTitle="Araç Adı Başlığı"
TextCarName="Araç Adı Metni"
CarName="Araç Adı"

#settings.php
Please choose your vehicle="Lütfen arajınızı seçin"
Credentials="Bilgileriniz"
Language="Dil"
Power="Güç"
Temperatur="Isı"
Unit of length="Uzunluk birimi"
URL Admin Panel="Yönetici Paneli URL'si"
All="Hepsi"
Stable="Saglam"
None="Yok"
Enable="Etkinleştir"
Celsius="Santigrat"
Fahrenheit="Fahrenhayt"
URL Grafana="Grafna URL'si"
Teslalogger HTTP Port="Teslalogger HHTP Portu"
Zoom Level="Yakınlaştırma Seviyesi"
ScanMyTesla integration="ScanMyTesla entegrasyonu"
Main Car="Ana Araç"
Car Name="Araç Adı"
ScanMyTesla last received="ScanMyTesla son alınan"
Tasker Token="Tasker Token"
Tasker URL="Tasker URL"
Received Tasker Token="Gelen Tasker Token"
Show calc. 100% range="Hesaplanan 100% menzili göster"
Saved!="Kaydeldi"
MyTesla="MyTesla"
Teslalogger Adminpanel="Teslalogger Yönetici Paneli"
Temperature="Sıcaklık"
mile="Mil"
Ideal="İdeal"
Rated="Nominal"
Share data anonymously="Verileri anonim olarak paylaş"
Sleep="Uyku"
to="ile"
Position by StreamingAPI="StreamingAPI`den gelen konum"

#Alle Verbräuche - ScanMyTesla.json
Alle Verbräuche - ScanMyTesla="Tüm Tüketimler"
Zelltemperatur [°C]="Hücre Sıcaklığı [°C]"
Zelltemperatur [°F]="Hücre Sıcaklığı [°F]"

#Trip Monatsstatistik.json
Datum="Tarih"
Fahrzeit [h]="Sürüş Süresi [sa]"
Strecke [km]="Mesafe [km]"
Strecke [mi]="Mesafe [mi]"
Verbrauch [kWh]="Tüketim [kWsa]"
Ø Verbrauch [kWh]="Ort. Tüketim [kWh]"
Anzahl Trips="Yolculuk Sayısı"
Trip Monatsstatistik="Aylık Yolculuk İstatistikleri"
Trip Jahresstatistik="Yıllık Yolculuk İstatistikleri"
Jahr/Monat="Yıl/Ay"
Zellspannungen 01-20 - ScanMyTesla="Hücre Voltajları 01-20 - ScanMyTesla"
Zellspannungen 21-40 - ScanMyTesla="Hücre Voltajları 21-40 - ScanMyTesla"
Zellspannungen 41-60 - ScanMyTesla="Hücre Voltajları 41-60 - ScanMyTesla"
Zellspannungen 61-80 - ScanMyTesla="Hücre Voltajları 61-80 - ScanMyTesla"
Zellspannungen 81-99 - ScanMyTesla="Hücre Voltajları 81-99 - ScanMyTesla"
Zellspannungen="Hücre Voltajları"
Zellspannung="Hücre Voltajı"
Ja="Evet"
Nein="Hayır"
Einschlafen="Uyku Moduna Geç"
Automatic updates="Otomatik Güncelleme"
TextShare="<h1>Şarj eğrilerini / Degradasyon eğrilerini anonim olarak paylaşın</h1>  \nAnonim bir veritabanı oluşturarak degradasyon ve şarj eğrilerini karşılaştırmak istiyoruz. Bu sayede aracınızı her zaman diğerleriyle kıyaslayabilir ve olası anormal sapmaları erken aşamada tespit edebilirsiniz. Ayrıca, aracınızı satarken bataryanızın hala tam verimli çalıştığını kanıtlamak için de kullanılabilir. Olumsuz bir durumda, Tesla Motors'a karşı azalan performansı daha kolay kanıtlayabilirsiniz.  \n\nAracınızın hızlı şarj eğrilerini ve degradasyon eğrilerini diğer Tesla sürücüleriyle tamamen anonim olarak paylaşmak ister misiniz? Bu kararı istediğiniz zaman ayarlar ekranından değiştirebilirsiniz."
Daten anonym teilen="Verileri anonim olarak paylaş"
TextSuspendTeslalogger="Teslalogger'ı Askıya Al"
Resume Teslalogger="Günlükleyiciyi Devam Ettir"
Range="Menzil"
Ladekosten="Sarj Maliyetleri"
Ladesäule="Sarj İstasyonu"
Währung="Para Birimi"
Kosten pro kWh="kWsa başına maliyet"
Kosten pro Ladung="Şarj başına maliyet"
Kosten pro Minute="Dakika başına maliyet"
Kosten Blockiergebühr="Bloke ücreti maliyeti"
Summe="Toplam"
kWh laut Zähler / Rechnung="Sayaça göre kWsa/Fatura"
Wirkungsgrad="Verimlilik"

#Timeline Plugin.json
Dauer="Süre"
Parking="Park etme"
Driving="Sürüş"
Missing="Eksik"
Ø Temperatur="Ort. Sıcaklık"
Verbraucht="Tüketilen"
StreamingPosHelp="<h1>StreamingAPI ile Konum</h1>  \nAracın konumunu Teslalogger veritabanına kaydetmek için StreamingAPI'yi kullanın. Aracın çekim gücüne bağlı olarak, bu yöntem normal modda her beş saniyede bir konum kaydetmek yerine saniyede beş konuma kadar kayıt yapabilir. Bu, veritabanınızın boyutunu önemli ölçüde artırır, SD kartın daha hızlı yıpranmasına neden olabilir ve büyük yedek dosyalar oluşturabilir."

#journeys.php
Ladezeit [h]="Şarj Süresi [sa]"
Journeys="Yolculuklar"
Journey name missing!="Yolculuk adı eksik!"
Please select="Lütfen seçiniz"
Please select start point!="Lütfen başlangıç noktasını seçin!"
Please select end point!="Lütfen bitiş noktasını seçin!"
TextJourneys="Yolculukları, uzun bir seyahati veya belirli bir süreyi birleştirmek ve tüm verileri özetlemek için kullanabilirsiniz. Bu, uzun bir yolculuğun toplam şarj süresini takip etmek veya yaz ve kış lastiklerinin tüketim değerlerini karşılaştırmak için oldukça faydalıdır."
ID="No"
Journey="Yolculuk"
Start address="Başlangıç adresi"
Target address="Hedef adresi"
End="Bitiş"
Consumed kWh="Tüketilen kWsa"
Charged kWh="Şarj edilen kWh"
Drive time [h]="Sürüş süresi [sa]"
Charge time [h]="Şarj süresi [sa]"
Distance [mi]="Mesafe [mil]"
Distance [km]="Mesafe [km]"
Charging costs="Şarj maliyetleri"
CO2 [kg]="CO2 [kg]"
New Journey="Yeni Yolculuk"
Journey name="Yolculuk adı"
Please wait="Lütfen bekleyin"
Please select start first="Lütfen önce başlangıcı seçiniz"
DelJourney="Yolculuğu Sil"
Display _MENU_ records per page="Sayfa başına _MENU_ kayıt göster"
Nothing found="Bir şey bulunamadı"
Showing _START_ to _END_ of _TOTAL_ entries="_START_'tan _END_'e kadar _TOTAL_ kayıtlar gösteriliyor"
No records available="Hic bir kayıt mevcut değil"
(filtered from _MAX_ total records)="(toplam _MAX_ kayıttan filtrelendi)"
Search="Arama"
First="İlk"
Last="Son"
Next="Sonraki"
Previous="Önceki"

#Status.json
Current Status="Mevcut Durum"
SOC="Şarj Durumu (SOC)"
Reichweite="Menzil"
Außentemperatur="Dış Sıcaklık"
Zelltemperatur="Hücre Sıcaklığı"
Nur verfügbar mit ScanMyTesla="Sadece ScanMyTesla üzeri mevcut"

#abrp.php
ABRPTitle="ABRP"
TextABRP="Teslalogger'dan Abetterrouteplanner'a bir bağlantı kurarak Tesla kimlik bilgilerinizi üçüncü taraflara vermekten kaçınabilirsiniz. Bir diğer avantaj ise, birden fazla hizmet kimlik bilgilerinizi kullanıyorsa, aracın uyku moduna geçmesini engelleme olasılığını en aza indirmektir."
ABRP1="ABRP1"
ABRP2="ABRP1"
ABRP3="ABRP1"
ABRP4="ABRP1"
ABRP5="ABRP1"
ABRP6="ABRP1"
ABRP7="ABRP1"
ABRP8="ABRP1"
ABRP9="ABRP1"
ABRPYT="ABRPYT"
ABRPToken="ABRPToken"
Enabled="Etkin"

#wallbox.php
Wallbox="Duvar Kutusu"
WallboxComment="Teslalogger'ınızı Wallbox'a bağlayarak şarj verimliliğini veya aracınızı şarj etmek için kullanılan fotovoltaik enerji yüzdesini hesaplayabilirsiniz."
Host="Sunucu"
Param="Parametre"
Test="Test"
Type="Tür"
Info="Bilgi"
Version="Sürüm"
Utility kWh="Şebeke kWSa"
Vehicle kWh="Araç kWSa"

#mqtt.php
MQTTSettings="MQTT Ayarları"
MQTTSettingsInfo="MQTT Ayarları Bilgisi"
TopicStructure="Konu Yapısı"
MQTT1="MQTT1"
MQTT2="MQTT2"
MQTT3="MQTT3"
MQTT4="MQTT4"
MQTT5="MQTT5"
ADDescription="AD Açıklaması"
MQTTAD1="MQTTAD1"
ControlTopic="Kontrol Konusu"
MQTT6="MQTT6"
MQTT7="MQTT7"
RebootAfterSave="Kaydettikten Sonra Yeniden Başlat"
Host="Sunucu"
Port="Port"
Topic="Konu"
PublishJson="JSON Yayınla"
Singletopics="Tekil Konular"
ClientID="İstemci Kimliği"
AutoDiscovery="Otomatik Keşif"
AutoDiscoveryTopic="Otomatik Keşif Konusu"

#komoot.php
KomootSettings="Komoot Ayarları"
KomootSettingsInfo="Komoot Ayarlar Bilgisi"

#superchargebingo.php
SuperChargeBingo="SuperChargeBingo"
SuperChargeBingoComment="TeslaLogger'ı SuperChargeBingo'ya bağlayarak, Supercharger istasyonlarında otomatik olarak giriş yapabilirsiniz."
Setup="Kurulum"
Create a SuperChargeBingo account="SuperChargeBingo hesabı oluştur"
Create API key (must be secure)="API anahtarı oluştur (güvenli olmalı)"
Copy Username and API key and insert it in TeslaLogger="Kullanıcı adını ve API anahtarını kopyalayıp TeslaLogger'a ekleyin"
Save and restart TeslaLogger="Kaydedin ve yeniden başlatın"
Username="Kullanıcı adı"
API key="API anahtarı"

#geoadd.php
Name & Position="Ad & Konum"
Description="Açıklama"
Radius="Yarıçap"
Special Flags="Özel Bayraklar"
Home="Ev"
Work="İş"
Charger="Şarj Tipi"
Copy Charging Costs="Şarj Maliyetlerini Kopyala"
Don't Combine Charging Sessions="Şarj Oturumlarını Birleştirme"
Set Charge Limit="Şarj Limitini Belirt"
Set on arrival="Varışta Belirt"
Set Charge Limit After Charging="Şarjdan Sonra Şarj Limitini Ayarla Belirtin"
Open Charge Port="Şarj Portunu Aç"
Gear="Vites"
D → P="D → P"
D/R → P="D/R → P"
R → P="R → P"
High Frequency Logging="Yüksek Frekanslı Günlük Kaydı"
Minutes="Dakika"
Special Count="Özel Sayım"
Count="Sayım"
Special Features="Özel Özellikler"
Enable Sentry Mode="Nöbetçi Modunu Etkinleştir"
Disable Sentry Mode="Nöbetçi Modunu Devre Dışı Bırak"
Turn HVAC off="Klimayı Kapat"
No sleep="Uyumak Yok"
Delete="Sil"
Are you sure you want to delete this geofencing location?="Bu coğrafi sınırlama konumunu silmek istediğinizden emin misiniz?"
Error="Hata"
Deleted!="Silindi!"
Meter="Metre"

#adminpanelpassword.php
Please enter password!="Lütfen şifreyi girin!"
Passwords do not match!="Şifreler eşleşmiyor!"
Do you want to delete your password?="Şifrenizi silmek istiyor musunuz?"
Set password for Teslalogger's admin panel="Teslalogger'ın yönetici paneli için şifre belirleyin"
Name="Ad"

#changelog.php
Changelog="Değişim Kayıtları"

#chargingcost.php
Charging Costs="Şarj Maliyetleri"
Date="Tarih"
Charged="Şarj Edilen"
Efficiency="Verimlilik"
Currency="Para Birimi"
kWh according to meter/invoice="Sayaça göre metre/Fatura"
Cost per kWh="kWsa başına maliyet"
Cost per charge="Şarj başına maliyet"
Cost per minute="Dakika başına maliyet"
Idle cost per minute="Boşta kalma maliyeti (dakika başına)"
Total="Toplam"

#logfile.php
Download Logfile="Günlüğü İndir"
Lines="Satırlar"
Housekeeping="Bakım/Temizlik"
Sleep Attempt="Uyuma Deneyimi"

#ovms.php
Please enter your dexters-web.de account credentials="Lütfen dexters-web.de hesap bilgilerinizi girin"
Dexter Login="Dexter Kullanıcı adi"
Dexter Password="Dexter Şifresi"

#password_info.php
Credentials Info="Kimlik Bilgileri"

#restore.php
Restore Database="Veritabanını Geri/Tekrar Yükle"
TextRestore1="Metin Geri Yükleme 1"
TextRestore2="Metin Geri Yükleme 2"
TextRestore3="Metin Geri Yükleme 3"

#dashboard.php
Sleeping="Uyku Mode"

#Vehicle Alerts
Fahrzeug Fehler="Araç Hatası"
startedAt="Başlangıç"
endedAt="Bitiş"
Häufigkeit="Sıklık"
Fehler="Hata"
INFO_DEPRECATED_DOCKER="Eski Docker sürümü. Lütfen NET8 sürümüne güncelleyin."
