#Akku Trips.json
Akku Trips=Akku Trips
Start Trip=Start Trip
End Trip=End Trip
Time=Date
StartSOC=StartSOC
EndSOC=EndSOC
SOC diff=SOC diff
Start km=Start km
End km=End km
Start mi=Start mi
End mi=End mi
kmDiff=kmDiff
Max Range=Max Range
Ø Verbrauch=Ø Consumption
Tage=Days

#Degradation.json
Degradation=Degradation
Maximalreichweite [km]=Max Range [km]
Maximalreichweite [mi]=Max Range [mi]
km Stand [km]=Odometer [km]
mi Stand [mi]=Odometer [mi]
Odometer [mi]=
Max. Reichweite (Monatsmittel) [km]=Max Rage (monthly avg) [km]
Max. Reichweite (Monatsmittel) [mi]=Max Rage (monthly avg) [mi]

#Ladehistorie.json
Ladehistorie=Charging History
Startdatum=Start Date
Enddatum=End Date
geladen kWh=kWh Charged
km Stand=Odometer
Adresse=Address
TR km Start=TR km Start
TR km Ende=TR km End
SOC Ende=SOC End
100% TR=100% TR
Minuten=Minutes
TR mi Start=TR mi Start
TR mi Ende=TR mi End
ØkW=ØkW

#Ladestatistik.json
Ladestatistik=Charging Statistics
Letzte Ladung=Last Charging
Ort=Address
Ø geladen kWh=Ø Charged kWh
Ladezeit h=Charge Duration h
Ø SOC=Ø SOC
Max SOC=Max SOC
Anzahl Ladungen=Charging Count
Anzahl=Count
Geladen=Charged
Ladezeit=Charging Time
Anz. Ladungen=Count
Ladehub=Charging Range

#SOC Ladestatistik.json
SOC Ladestatistik=SOC Charging Statistics
SOC [%]=SOC [%]

#Laden.json
Laden=Charging
Ladespannung [V]=Charging Voltage [V]
Reichweite [mi]=Range [mi]
Reichweite [km]=Range [km]
Leistung [kW]=Power [kW]
Phasen=Phases
Stromstärke [A]=Current [A]
Angefordert [A]=Requested [A]
Pilot [A]=Pilot [A]

#Vampir Drain Monatsstatistik.json
Vampir Drain Monatsstatistik=Vampir Drain Monthly Statistics
TR mi Verlust=TR mi Lost
kWh Verlust=kWh Lost
Eur Verlust=Eur Lost

#Trip.json
Trip=Trip
Start=Start
Ende=End
Start Adresse=Start Address
Ziel Adresse=Destination Address
Ø Verbrauch kWh=Ø Consumption kWh
Verbraucht kWh=Consumed kWh
Dauer Min=Duration Min
mi=mi
km=km
Ø °C=Ø °C
Ø °F=Ø °F
max mph=Max mph
max km/h=max kph
max PS=Max HP
min PS=Min HP
max kW=max kW
min kW=min kW
Ø PS=Ø HP
Ø kW=Ø kW
Ø mph=Ø mph
Ø km/h=Ø kph

#Vampir Drain Monatsstatistik.json
Zeitspanne Stunden=Timespan Hours
TR mi Verlust pro Stunde=TR mi Lost per Hour
mi Stand=Odometer

#Vampir Drain.json
Vampir Drain=Vampir Drain
Standby Stunden=Standby Hours
Standby=Standby
TR km Verlust=TR km Lost
TR km Verlust pro Stunde=TR km Lost Per Hour

#Verbrauch.json
Verbrauch=Consumption
Höhe [m]=Altitude [m]
Altitude [m]=Altitude [m]
Geschwindigkeit [mph]=Speed [mph]
Geschwindigkeit [km/h]=Speed [kph]
Leistung [PS]=Power [HP]
Außentemperatur [°C]=Outside Temperature [°C]
Außentemperatur [°F]=Outside Temperature [°F]
Innentemperatur [°C]=Inside Temperature [°C]
Innentemperatur [°F]=Inside Temperature [°F]

Laden fertig=Charging Finished
Schlafen=Sleeping
Online=Online

#Visited.json
Visited=Visited

#index.php
Fahrzeuginfo=Car Info
Status=Status
Typical Range=Typical Range
KM Stand=Odometer
Car Version=Car Version
Letzter Trip=Last Trip
Dauer=Duration
Distanz=Distance
Max km/h=Max kph
PS=PS
Current Pos=Current Pos
Last Update=Last Update
Wird geladen=Charging
Done=Done
Done at=Done at
Battery Heater=Battery Heater
Sentry Mode=Sentry Mode
Preconditioning=Preconditioning
Offline=Offline

#menu.php
Logfile=Logfile
Restart=Restart
Update=Update
Dashboards=Dashboards
Fleet Statistic=Fleet Statistic
Extras=Extras
Settings=Settings
Backup=Backup
Restore=Restore
Geofence=Geofence
Suspend Teslalogger=Suspend Teslalogger
Wakeup Teslalogger=Wakeup Teslalogger
Dashboard=Dashboard

#password.php
Teslalogger Tesla Zugangsdaten=Teslalogger Tesla Credentials
Bitte Tesla Account Zugangsdaten eingeben=Please enter your Tesla account credentials
Email=Email
Passwort=Password
Passwort wiederholen=Repeate Password
Speichern=Save

#settings.php
Zugangsdaten=Credentials
Language=Language
Leistung=Power
Temperatur=Temperature
Längenmaß=Unit of length
URL Admin Panel=URL Admin Panel
All=All
Stable=Stable
None=None
Enable=Enable
Celsius=Celsius
Fahrenheit=Fahrenheit
URL Grafana=URL Grafana
Teslalogger HTTP Port=Teslalogger HTTP Port
Zoom Level=Zoom Level
ScanMyTesla integration=ScanMyTesla integration
Main Car=Main Car
Car Name=Car Name
ScanMyTesla last received=ScanMyTesla last received
Tasker Token=Tasker Token
Tasker URL=Tasker URL
Received Tasker Token=Received Tasker Token

#geoadd.php
Bezeichnung=Description

#Alle Verbräuche - ScanMyTesla.json
Alle Verbräuche - ScanMyTesla=All consumptions - ScanMyTesla
Zelltemperatur [°C]=Cell Temperature [°C]
Zelltemperatur [°F]=Cell Temperature [°F]

#Trip Monatsstatistik.json
Datum=Date
Fahrzeit [h]=Drive Time [h]
Strecke [km]=Distance [km]
Strecke [mi]=Distance [mi]
Verbraucht [kWh]=Consumed kWh
Ø Verbrauch [kWh]=Ø Consumption kWh
Anzahl Trips=Trips Count
Trip Monatsstatistik=Trip Monthly Statistics

Zellspannungen 01-20 - ScanMyTesla=Cell Voltages 01-20 - ScanMyTesla
Zellspannungen 21-40 - ScanMyTesla=Cell Voltages 21-40 - ScanMyTesla
Zellspannungen 41-60 - ScanMyTesla=Cell Voltages 41-60 - ScanMyTesla
Zellspannungen 61-80 - ScanMyTesla=Cell Voltages 61-80 - ScanMyTesla
Zellspannungen 81-99 - ScanMyTesla=Cell Voltages 81-99 - ScanMyTesla

Ja=Yes
Nein=No

Einschlafen=Falling asleep
Automatische Updates=Automatic updates

TextShare=<h1>Share charge curves / degradation curves anonymously</h1>We would like to create an anonymous database to compare degradation curves and charge curves. This allows you to compare your vehicle with others at any time and to detect any unusual deviation at an early stage. This can also be used later to prove during the sales talk that your battery is still fully efficient. In the negative case, you can more easily prove a reduced performance against Tesla Motors.<br><br>Would you like to share your fast charging curves and degradation curves with other Tesla drivers completely anonymously? This decision can be changed at any time in the settings screen.
Daten anonym teilen=Share data anonymously
TextSuspendTeslalogger=Teslalogger has been stopped! Data will not be logged!
Resume Teslalogger=Resume Teslalogger
Reichweite=Range

Ladekosten=Charging Costs
Ladesäule=Charging Station
Währung=Currency
Kosten pro kWh=Cost per kWh
Kosten pro Ladung=Cost per charge
Kosten pro Minute=Cost per minute
Kosten Blockiergebühr=Idle cost per minute
Summe=Total
kWh laut Zähler / Rechnung=kWh according to meter / invoice
Wirkungsgrad=Efficiency
