#Generel
Delete=Slet
Save=Gem
Settings=Indstillinger
Setup=Opsætning
Enabled=Aktiveret
kWh=kWh

#Akku Trips.json
Akku Trips=Siden sidste opladning
Start Trip=Start Tur
End Trip=Stop Tur
Time=Dato
StartSOC=Start SOC
EndSOC=Stop SOC
SOC diff=SOC diff
Start km=Start km
End km=Stop km
Start mi=Start mi
End mi=Stop mi
kmDiff=kmDiff
Max Range=Max Rækkevidde
Ø Verbrauch=Ø Forbrug
Tage=Dage

#Degradation.json
Degradation=Degradation
Maximalreichweite [km]=Max Rækkevidde [km]
Maximalreichweite [mi]=Max Rækkevidde [mi]
km Stand [km]=Kilometertæller [km]
mi Stand [mi]=Kilometertæller [mi]
Odometer [mi]=
Max. Reichweite (Monatsmittel) [km]=Max Rækkevidde (månedlig gennemsnit) [km]
Max. Reichweite (Monatsmittel) [mi]=Max Rækkevidde (månedlig gennemsnit) [mi]

#Ladehistorie.json
Ladehistorie=Opladningshistorik
Startdatum=Start Dato
Enddatum=End Dato
geladen kWh=kWh opladet
km Stand=Kilometertæller
Adresse=Adresse
TR km Start=TR km Start
TR km Ende=TR km Stop
SOC Ende=SOC Stop
100% TR=100% TR
Minuten=Minuter
TR mi Start=TR mi Start
TR mi Ende=TR mi Stop
ØkW=ØkW

#Ladestatistik.json
Ladestatistik=Opladningsstatistik
Letzte Ladung=Seneste opladning
Ort=Adresse
Ø geladen kWh=Ø Opladet kWh
Ladezeit h=Opladningsvarighed t
Ø SOC=Ø SOC
Max SOC=Max SOC
Anzahl Ladungen=Antal opladninger
Anzahl=Antal
Geladen=Opladet
Ladezeit=Lade tid
Anz. Ladungen=Antal
Ladehub=Opladningsområde

#SOC Ladestatistik.json
SOC Ladestatistik=SOC Opladningsstatistik
SOC [%]=SOC [%]

#Laden.json
Laden=Charging
Ladespannung [V]=Opladningsspænding [V]
Reichweite [mi]=Rækkevidde [mi]
Reichweite [km]=Rækkevidde [km]
Leistung [kW]=Effekt [kW]
Phasen=Faser
Stromstärke [A]=Strømstyrke [A]
Angefordert [A]=Anmodet [A]
Pilot [A]=Pilot [A]

#Vampir Drain Monatsstatistik.json
Vampir Drain Monatsstatistik=Vampire Drain Månedlige statistikker
TR mi Verlust=TR mi Tabt
kWh Verlust=kWh Tabt
Eur Verlust=Eur Tabt
Zeitspanne Stunden=Tidsrum
TR mi Verlust pro Stunde=TR mi Tabt pr time
mi Stand=Kilometertæller

#Trip.json
Trip=Trip
Start=Start
Ende=End
Start Adresse=Start Adresse
Ziel Adresse=Destinationsadresse
Ø Verbrauch kWh=Ø Forbrug kWh
Verbraucht kWh=Brugt kWh
Dauer Min=Varighed Min
mi=mi
km=km
Ø °C=Ø °C
Ø °F=Ø °F
max mph=Max mph
max km/h=max km/t
max PS=Max HK
min PS=Min HK
max kW=max kW
min kW=min kW
Ø PS=Ø HK
Ø kW=Ø kW
Ø mph=Ø mph
Ø km/h=Ø km/t

#Vampir Drain.json
Vampir Drain=Vampire Drain
Standby Stunden=Standby tid
Standby=Standby
TR km Verlust=TR km Tabt
TR km Verlust pro Stunde=TR km Tabt pr time

#Verbrauch.json
Verbrauch=Forbrug
Höhe [m]=Højde [m]
Altitude [m]=Højde [m]
Geschwindigkeit [mph]=Hastighed [mph]
Geschwindigkeit [km/h]=Hastighed [km/t]
Leistung [PS]=Power [HP]
Außentemperatur [°C]=Temperatur udendørs [°C]
Außentemperatur [°F]=Temperatur udendørs [°F]
Innentemperatur [°C]=Temperatur i bilen [°C]
Innentemperatur [°F]=Temperatur i bilen [°F]

Laden fertig=Opladning færdig
Schlafen=Sover
Online=Online

#Visited.json
Visited=Visited

#index.php
Car Info=Køretøjsinfo
Status=Status
Typical Range=Typical Range
Odometer=Kilometertæller
Car Version=Firmware Version
Last Trip=Seneste tur
Duration=Varighed
Distance=Distance
Max km/h=Max km/t
PS=HK
Current Pos=Aktuel position
Last Update=Senest opdateret
Charging=Lader
Done=Færdig
Done at=Færdig kl.
Battery Heater=Batterivarmer
Sentry Mode=Sentry Mode
Preconditioning=Forvarmer
Offline=Offline
Falling asleep=Dvale
Driving=Kørsel
Sleeping=Sovende
kW=kW
OK=OK
No=Nej
Yes=Ja
Cell Temp=Celletemperatur
Max Charge=Max opladning
Max Discharge=Max udledning
Cell Imbalance=Ubalance i cellerne
Software Update=Opdatering af software
Consumption=Forbrug
Ø Consumption=Ø Forbrug
min=min
Wh/km=Wh/km
km/h=km/t
Please update to latest docker-compose.yml file. Check: {LINK}=Opdater venligst til den nyeste docker-compose.yml-fil. Tjek: {LINK}

#menu.php
Logfile=Logfile
Restart=Genstart
Update=Opdatér
Dashboards=Dashboards
Fleet Statistic=Flåde Statistik
Extras=Ekstra
Backup=Backup
Restore=Genskab
Geofence=Geofence
Suspend Teslalogger=Paus Teslalogger
Wakeup Teslalogger=Væk Teslalogger
Dashboard=Dashboard
My Degradation=Min nedbrydning
My Charging AVG=Min opladning AVG
Fleet Degradation AVG=Nedbrydning af flåden AVG
Fleet Charging AVG=Flådeopladning AVG
Fleet Charging MAX (Firmware)=Fleet Charging MAX (firmware)
Fleet Charging Locations=Opladningssteder for flåden
Fleet Fast Charging Map=Kort over hurtig opladning i flåden
Supercharger Usage=Brug af kompressor
Firmware Tracker=Sporing af firmware
Abetterrouteplanner=Abetterrouteplanner

#password.php
Teslalogger Tesla Credentials=Teslalogger Tesla Credentials
Please enter your Tesla account credentials=Indtast dine Tesla account credentials
Email=Email
Password=Password
Repeat Password=Gentag Password
Speichern=Gem
Please enter the access token!=Indtast venligst adgangstoken!
Please enter the refresh token!=Indtast venligst opdateringstoken!
Please select a vehicle=Vælg venligst et køretøj
Check Logfile!=Check Logfile!
Do you really want to delete this vehicle?=Ønsker du virkelig at slette dette køretøj?
Check Logfile in one minute!=Tjek logfilen på et minut!
Unauthorized=Uautoriseret
This isn't a valid URL!=Dette er ikke en gyldig URL!
This isn't an auth link by Tesla!=Dette er ikke et auth-link fra Tesla!
The URL doesn't contain the expected format!=URL-adressen indeholder ikke det forventede format!
TeslaAuthApps=Du kan bruge følgende apps til at få et adgangstoken
BA_Browser=I lokal {browser} (anbefales)
BA_Read=Læs alle trinene, før du fortsætter:
BA_Logon=Klik på linket nedenfor med titlen <b>Tesla Logon</b>, som åbner en ny fane/et nyt vindue til Tesla Authentication-logon-siden
BA_Auth=Log på med dine Tesla-oplysninger og MFA, hvis det er nødvendigt (Tesla husker disse oplysninger, hvis du har brugt linket før).
BA_NotFound=Det ser ud til at resultere i en "Side ikke fundet". Dette er normalt.
BA_URL=Kopier URL'en til den pågældende webside ind i formularen nedenfor. I URL'en er der en midlertidig kode, som vi kan bruge til at generere tokens. Vi udtrækker den til dig fra linket.
BA_Invalid=Disse links fungerer typisk kun én gang, så hvis der vises en "Invalid Grant"- eller anden fejlmeddelelse på vores websted, skal du muligvis starte forfra med Tesla Logon-linket, som burde give et nyt link.
BA_Logoff=Hvis du vil bruge en anden konto, skal du logge af manuelt {her!}
BA_GetToken=Vi får derefter tokens til din Tesla-konto.
BA_SelectCar=Vælg den bil, du ønsker at bruge til Teslalogger.
BA_Step1=Trin 1:
BA_Step2=Trin 2:
BA_Step3=Trin 3:
BA_FillOut=Udfyld denne formular:
BA_CopyUrl=Kopier den resulterende url som vist
BA_Paste=Indsæt den resulterende url i feltet, og klik på knappen "Get Tokens":
Get Tokens=Få tokens
Access Token=Adgangstoken
Refresh Token=Opdateringstoken
Car=Bil
Free Supercharging=Gratis opladning
Reconnect=Genforbind
Please choose your vehicle=Vælg venligst dit køretøj
Model=Model
VIN=VIN
Free SUC=Gratis SUC
Edit=Rediger
New car=Ny bil

#settings.php
Credentials=Legitimationsoplysninger
Language=Sprog
Power=Effekt
Temperatur=Temperatur
Unit of length=Længdemål
URL Admin Panel=URL Admin Panel
All=Alle
Stable=Stabile
None=Ingen
Enable=Aktiver
Celsius=Celsius
Fahrenheit=Fahrenheit
URL Grafana=URL Grafana
Teslalogger HTTP Port=Teslalogger HTTP Port
Zoom Level=Zoom Niveau
ScanMyTesla integration=ScanMyTesla integration
Main Car=Primært køretøj
Car Name=Køretøjets navn
ScanMyTesla last received=Seneste ScanMyTesla
Tasker Token=Tasker Token
Tasker URL=Tasker URL
Received Tasker Token=Modtaget Tasker Token
Saved!=Reddet!
MyTesla=MyTesla
Teslalogger Adminpanel=Teslalogger Admin-panel
Temperature=Temperatur
mile=mile
Ideal=Ideel
Rated=Mærket
Share data anonymously=Del data anonymt
Sleep=Søvn
to=til
Show calc. 100% range=Vis beregninger. 100% område
Position by StreamingAPI=Position af StreamingAPI

#Alle Verbräuche - ScanMyTesla.json
Alle Verbräuche - ScanMyTesla=Alt forbore - ScanMyTesla
Zelltemperatur [°C]=Celle Temperatur [°C]
Zelltemperatur [°F]=Celle Temperatur [°F]

#Trip Monatsstatistik.json
Datum=Dato
Fahrzeit [h]=Rejsetid [t]
Strecke [km]=Distance [km]
Strecke [mi]=Distance [mi]
Verbraucht [kWh]=Forbrug kWh
Ø Verbrauch [kWh]=Ø Forbrug kWh
Anzahl Trips=Antal ture
Trip Monatsstatistik=Månedlig rejse-statistik

Zellspannungen 01-20 - ScanMyTesla=Cell Voltages 01-20 - ScanMyTesla
Zellspannungen 21-40 - ScanMyTesla=Cell Voltages 21-40 - ScanMyTesla
Zellspannungen 41-60 - ScanMyTesla=Cell Voltages 41-60 - ScanMyTesla
Zellspannungen 61-80 - ScanMyTesla=Cell Voltages 61-80 - ScanMyTesla
Zellspannungen 81-99 - ScanMyTesla=Cell Voltages 81-99 - ScanMyTesla

Ja=Ja
Nein=Nej

Einschlafen=Dvale
Automatic updates=Automatiske opdateringer

TextShare=<h1>Del opladningskurver / degraderingskurver anonymt </h1> Vi vil gerne oprette en anonym database for at sammenligne degraderingskurver og opladningskurver. Dette giver dig mulighed for at sammenligne dit køretøj med andre til enhver tid og opdage enhver usædvanlig afvigelse på et tidligt tidspunkt. Denne information kan være nyttig i en salgssituation som dokumentation for batteriets helbred. Ligeledes giver det dig værdifuld information i en eventuel dialog Tesla Motors hvis du oplever reduceret ydelse på batteriet. <br> <br> Vil du dele dine hurtige opladningskurver og degraderingskurver med andre Tesla ejere helt anonymt? Denne beslutning kan når som helst ændres under indstillingsmenuen.
StreamingPosHelp=<h1>Position af StreamingAPI</h1>aktiverer positionsdatabaseposter fra streaming API'et - afhængigt af bilens modtagelse betyder det op til 5 positioner i sekundet (sammenlignet med en position hvert femte sekund i normal tilstand), hvilket vil øge databasens størrelse betydeligt, øge sliddet på SD-kortet og resultere i store sikkerhedskopier.
Daten anonym teilen=Del data anonymt
TextSuspendTeslalogger=Teslalogger er blevet stoppet! Data vil ikke blive gemt!
Resume Teslalogger=Genoptag Teslalogger
Range=Rækkevidde

#abrp.php
ABRPTitle=Abetterrouteplanner Link
TextABRP=Du kan oprette et link fra Teslalogger til Abetterrouteplanner for at undgå at give dine Tesla-legitimationsoplysninger til en 3. part. En anden fordel er at minimere muligheden for at forhindre bilen i at gå i dvale, hvis mere end én tjeneste bruger dine legitimationsoplysninger.
ABRP1=Opret en Abetterrouteplanner-konto
ABRP2=Gå til Indstillinger
ABRP3=Vælg din bil
ABRP4=Gem din bil på din konto
ABRP5=Giv din bil et navn
ABRP6=Klik på "Link Generic" for at få et ABRP-token
ABRP7=Kopiér tokenet og klik på "Udført"
ABRP8=Indsæt tokenet i Teslalogger
ABRP9=Tjek om Teslaloggeren er tilsluttet
ABRPYT=Tjek YouTube tutorial for live demo
ABRPToken=Abetterrouteplanner-token

#chargingcost.php
Charging Costs=Opladningspris
Charged=Opladet
Date=Dato
Efficiency=Effektivitet
Currency=Valuta
kWh according to meter/invoice=kWh i følge tæller / faktura
Cost per kWh=Pris per kWh
Cost per charge=Pris per opladning
Cost per minute=Pris per minut
Idle cost per minute=Blokeringsgebyr per minut
Total=I alt
Charger=Opladningssted
Minutes=Protokol

#wallbox.php
Wallbox=Wallbox
WallboxComment=Du kan tilslutte din Teslalogger til din Wallbox for at beregne effektiviteten af opladningen eller den procentdel af solcellerne, der bruges til at oplade din bil.
Host=Host
Param=Param
Test=Test
Type=Type
Info=Info
Version=Version
Utility kWh=Utility kWh
Vehicle kWh=Køretøj kWh

#superchargebingo.php
SuperChargeBingo=SuperChargeBingo
SuperChargeBingoComment=Du kan oprette et link fra TeslaLogger til SuperChargeBingo for at udføre automatiske checkins ved Superchargers.
Create a SuperChargeBingo account=Opret en SuperChargeBingo-konto
Create API key (must be secure)=Opret API-nøgle (skal være sikker)
Copy Username and API key and insert it in TeslaLogger=Kopier brugernavn og API-nøgle, og indsæt den i TeslaLogger
Save and restart TeslaLogger=Gem og genstart TeslaLogger
Username=Brugernavn
API key=API-nøgle

#geoadd.php
Name & Position=Navn
Description=Beskrivelse
Radius=Radius
Special Flags=Særlige flag
Home=Hjem
Work=Arbejde
Copy Charging Costs=Udgifter til kopiering af opladning
Don't Combine Charging Sessions=Kombiner ikke opladningssessioner
Set Charge Limit=Indstil opladningsgrænse
SOC=SOC
Set on arrival=Set ved ankomsten
Set Charge Limit After Charging=Indstil opladningsgrænse efter opladning
Open Charge Port=Åben opladningsport
Gear=Gear
D → P=D → P
D/R → P=D/R → P
R → P=R → P
High Frequency Logging=Logning med høj frekvens
Special Count=Særlig optælling
Count=Greve
Special Features=Særlige funktioner
Enable Sentry Mode=Aktiver vagttilstand
Disable Sentry Mode=Deaktivere vagttilstand
Turn HVAC off=Sluk for HVAC
No sleep=Ingen søvn
Are you sure you want to delete this geofencing location?=Er du sikker på, at du vil slette denne geofencing-position?
Error=Fejl
Deleted!=Slettet!
Meter=Meter

#journeys.php
Journeys=Rejser
Journey name missing!=Rejsenavn mangler!
Please select=Vælg venligst
Please select start point!=Vælg venligst startpunkt!
Please select end point!=Vælg venligst slutpunkt!
TextJourneys=Du kan bruge rejser til at kombinere en lang rejse/tid og opsummere alle tal. Dette er meget nyttigt til at spore den komplette opladningstid for en lang tur eller til at sammenligne forbruget af sommer- eller vinterdæk.
ID=ID
Journey=Rejse
Start address=Start adresse
Target address=Måladresse
End=Slut
Consumed kWh=Forbrugt kWh
Charged kWh=Opladet kWh
Drive time [h]=Køretid [h]
Charge time [h]=Opladningstid [h]
Distance [mi]=Afstand [mi]
Distance [km]=Afstand [km]
Charging costs=Opkrævningsomkostninger
CO2 [kg]=CO2 [kg]
New Journey=Ny rejse
Journey name=Navn på rejsen
Please wait=Vent venligst
Please select start first=Vælg venligst start først
DelJourney=Ønsker du virkelig at slette rejsen {id}?
Display _MENU_ records per page=Vis _MENU_ poster pr. side
Nothing found=Intet fundet
Showing _START_ to _END_ of _TOTAL_ entries=Viser _START_ til _END_ af _TOTAL_ poster
No records available=Ingen optegnelser tilgængelige
(filtered from _MAX_ total records)=(filtreret fra _MAX_ samlede antal poster)
Search=Søg på
First=Første
Last=Sidst
Next=Næste
Previous=Forrige

#adminpanelpassword.php
Please enter password!=Indtast venligst adgangskode!
Passwords do not match!=Adgangskoderne passer ikke sammen!
Do you want to delete your password?=Ønsker du at slette din adgangskode?
Set password for Teslalogger's admin panel=Indstil adgangskode til Teslaloggers administrationspanel
Name=Navn

#changelog.php
Changelog=Ændringsliste

#logfile.php
Download Logfile=Download logfil
Lines=Linjer
Housekeeping=Rengøring
Sleep Attempt=Forsøg på at sove

#ovms.php
Please enter your dexters-web.de account credentials=Indtast venligst dine dexters-web.de kontooplysninger
Dexter Login=Dexter Login
Dexter Password=Dexter Adgangskode

#password_info.php
Credentials Info=Oplysninger om legitimationsoplysninger

#restore.php
Restore Database=Gendan database
TextRestore1=Sørg for at tage en sikkerhedskopi af din Teslalogger, før du gendanner databaser. Flyt din sikkerhedskopimappe fra \\RASPBERRY\teslalogger\backup til din harddisk!
TextRestore2=Gendannelsesprocessen kan tage op til 10 minutter!
TextRestore3=Du må ikke afbryde gendannelsesprocessen på nogen måde! Du må ikke genindlæse siden! Du må ikke lukke denne side!
