#Em geral
Delete=Excluir
Save=Salve
Settings=Definições
Setup=Configuração
Enabled="Habilitado"

#Akku Trips.json
Akku Trips=Viagens
Start Trip=Início da Viagem
End Trip=Fim da Viagem
Time=Data/Hora
StartSOC=SoC Inicial
EndSOC=SoC Final
SOC diff=Diferença de SoC
Start km=Km Iniciais
End km=Km Finais
Start mi=Mi Iniciais
End mi=Mi Finais
kmDiff=Diferença de Km
Max Range=Autonomia Máxima
Ø Verbrauch=Ø Consumo
Tage=Dias

#Degradation.json
Degradation=Degradação
Maximalreichweite [km]=Autonomia Máxima [km]
Maximalreichweite [mi]=Autonomia Máxima [mi]
km Stand [km]=Odómetro [km]
mi Stand [mi]=Odómetro [mi]
Odometer [mi]=Odómetro [mi]
Max. Reichweite (Monatsmittel) [km]=Autonomia Máxima (média mensal) [km]
Max. Reichweite (Monatsmittel) [mi]=Autonomia Máxima (média mensal) [mi]

#Ladehistorie.json
Ladehistorie=Historial de Carregamentos
Startdatum=Data/Hora Inicial
Enddatum=Data/Hora Final
geladen kWh=kWh Carregados
km Stand=Odómetro
Adresse=Endereço
TR km Start=TR km Iniciais
TR km Ende=TR km Finais
SOC Ende=SoC Final
100% TR=100% TR
Minuten=Minutos
TR mi Start=TR mi Iniciais
TR mi Ende=TR mi Finais
ØkW=ØkW

#Ladestatistik.json
Ladestatistik=Estatísticas de Carregamento
Letzte Ladung=Último Carregamento
Ort=Endereço
Ø geladen kWh=Ø kWh Carregados
Ladezeit h=Duração do Carregamento h
Ø SOC=Ø SoC
Max SOC=SoC Máximo
Anzahl Ladungen=Contagem de Carregamentos
Anzahl=Contagem
Geladen=Carregado
Ladezeit=Tempo de Carregamento
Anz. Ladungen=Countagem
Ladehub=Autonomia do Carregamento

#SOC Ladestatistik.json
SOC Ladestatistik=Estatísticas de SoC
SOC [%]=SoC [%]

#Laden.json
Laden=Carregamento
Ladespannung [V]=Voltagem [V]
Reichweite [mi]=Autonomia [mi]
Reichweite [km]=Autonomia [km]
Leistung [kW]=Potência [kW]
Phasen=Fases
Stromstärke [A]=Corrente [A]
Angefordert [A]=Requeridos [A]
Pilot [A]=Piloto [A]

#Vampir Drain Monatsstatistik.json
Vampir Drain Monatsstatistik=Estatísticas Perdas Residuais
TR mi Verlust=TR mi Perdidas
kWh Verlust=kWh Perdidos
Eur Verlust=EUR Perdidos
Zeitspanne Stunden=Horas de Duração
TR mi Verlust pro Stunde=TR mi Perdidas por Hora
mi Stand=Odómetro

#Trip.json
Trip=Viagem
Start=Início
Ende=Fim
Start Adresse=Endereço Inicial
Ziel Adresse=Endereço Final
Ø Verbrauch kWh=Ø Consumo kWh
Verbraucht kWh=kWh Consumidos
Dauer Min=Duração Min
mi=mi
km=km
Ø °C=Ø °C
Ø °F=Ø °F
max mph=Max mph
max km/h=Max km/h
max PS=Max CV
min PS=Min CV
max kW=max kW
min kW=min kW
Ø PS=Ø CV
Ø kW=Ø kW
Ø mph=Ø mph
Ø km/h=Ø km/h

#Vampir Drain.json
Vampir Drain=Perdas Residuais
Standby Stunden=Horas em Standby
Standby=Standby
TR km Verlust=TR km Perdidos
TR km Verlust pro Stunde=TR km Perdidos por Hora

#Verbrauch.json
Verbrauch=Consumo
Höhe [m]=Altitude [m]
Altitude [m]=Altitude [m]
Geschwindigkeit [mph]=Velocidade [mph]
Geschwindigkeit [km/h]=Velocidade [km/h]
Leistung [PS]=Potência [CV]
Außentemperatur [°C]=Temperatura Exterior [°C]
Außentemperatur [°F]=Temperatura Exterior [°F]
Innentemperatur [°C]=Temperatura Interior [°C]
Innentemperatur [°F]=Temperatura Interior [°F]
Laden fertig=Carregamento Terminado
Schlafen=Adormecido
Online=Ligado

#Visited.json
Visited=Visitado

#index.php
Car Info="Informação do Veículo"
Status=Estado
Typical Range=Autonomia Típica
Odometer=Odómetro
Car Version=Versão do Veículo
Last Trip=Última Viagem
Duration=Duração
Distance=Distância
Max km/h="km/h Máximos"
PS=CV
Falling asleep=Adormecer
Charging=Carregamento
Done=Feito
Done at=Feito em
Driving=Condução
km/h=km/h
Preconditioning=Pré-condicionamento
Sentry Mode=Modo sentinela
Battery Heater=Aquecedor a pilhas
Sleeping=Dormir
Offline=Offline
OK=OK
No=Não
Yes=Sim
Cell Temp=Temperatura da célula
Max Charge=Carga máxima
Max Discharge=Descarga máxima
Cell Imbalance=Desequilíbrio celular
Last Update=Última Actualização
Software Update=Actualização de software
min=min
Consumption=Consumo
Ø Consumption="Ø Consumo"
kWh=kWh
Wh/km=Wh/km
Current Pos=Pos actuais
Please update to latest docker-compose.yml file. Check: {LINK}=Favor actualizar para o ficheiro docker-compose.yml mais recente. Verificar: {LINK}

#password.php
Teslalogger Tesla Credentials=Teslalogger Credenciais Tesla
Please enter your Tesla account credentials=Por favor, insira as suas credenciais da conta Tesla
Email="Email"
Password=Palavra-passe
Repeat Password=Repita Palavra-passe
Speichern=Guardar
Please enter the access token!=Por favor, introduza o código de acesso!
Please enter the refresh token!=Por favor, introduza o símbolo de actualização!
Please select a vehicle=Por favor, seleccione um veículo
Check Logfile!=Verifique o ficheiro de registo!
Do you really want to delete this vehicle?="Quer mesmo apagar este veículo?"
Check Logfile in one minute!=Verifique o ficheiro de registo dentro de um minuto!
Unauthorized=Não autorizado
This isn't a valid URL!="Este não é um URL válido!"
This isn't an auth link by Tesla!=Este não é um auth link de Tesla!
The URL doesn't contain the expected format!="O URL não contém o formato esperado!"
TeslaAuthApps="Pode utilizar as seguintes aplicações para obter um token de acesso e de actualização a partir do servidor Tesla:"
BA_Browser=No local {browser} (recomendado)
BA_Read=Por favor, leia todos os passos antes de continuar:
BA_Logon=Clique no link abaixo intitulado <b>Tesla Logon</b> que abrirá um novo separador/janela para a página de logon do Tesla Authentication
BA_Auth=Inicie a sessão utilizando as suas credenciais Tesla e AMF se necessário (Tesla lembrar-se-á delas se já tiver utilizado a ligação antes)
BA_NotFound=Isto parecerá resultar numa "Página Não Encontrada". Isto é normal.
BA_URL="Copie o URL resultante dessa página web para o formulário abaixo. Dentro do URL é um código temporário único que podemos utilizar para gerar fichas. Extrairemo-lo para si a partir da ligação."
BA_Invalid=Estas ligações normalmente só funcionam uma vez, portanto, se uma "Invalid Grant" ou outra mensagem de erro aparecer no nosso sítio Web, poderá ter de começar novamente com a ligação Tesla Logon, que deverá produzir uma nova ligação.
BA_Logoff=Se quiser usar uma conta diferente, tem de fazer o log off manualmente {aqui!}
BA_GetToken="Receberemos então os tokens para a sua conta Tesla."
BA_SelectCar="Seleccione o carro que pretende utilizar para o Teslalogger."
BA_Step1=Passo 1:
BA_Step2=Passo 2:
BA_Step3=Passo 3:
BA_FillOut=Preencha este formulário:
BA_CopyUrl="Copiar a URLresultante, como mostrado"
BA_Paste="Colar a URL resultante na caixa e clicar no botão "_QQ_"Obter fichas"_QQ_" Button:"
Get Tokens=Obter fichas
Access Token=Ficha de Acesso
Refresh Token=Ficha de Actualização
Car="Automóvel"
Free Supercharging=Super-carregamento gratuito
Reconnect=Voltar a ligar
Please choose your vehicle=Por favor escolha o seu veículo
Model=Modelo
VIN=VIN
Free SUC=SUC grátis
Edit=Editar
New car="Carro novo"

#settings.php
Credentials=Credenciais
Language=Língua
Power=Potência
Temperatur=Temperatura
Unit of length=Unidade de distância
URL Admin Panel=URL Painel Administração
Saved!=Salvo!
MyTesla=MyTesla
Teslalogger Adminpanel=Painel de administração do Teslalogger
kW=kW
Temperature=Temperatura
Celsius=Celsius
Fahrenheit=Fahrenheit
mile=milha
Ideal=Ideal
Rated=Classificado
Share data anonymously=Partilhar dados de forma anónima
Enable="Habilitar"
All=Todos
Stable=Estável
None=Nenhum
Sleep=Dormir
to=para
Show calc. 100% range=Mostrar cálculo. 100% gama
URL Grafana=URL Grafana
Teslalogger HTTP Port=Porta HTTP Teslalogger
Zoom Level=Nível de Zoom
ScanMyTesla integration=Integração ScanMyTesla
Position by StreamingAPI=Posição por StreamingAPI
Main Car="Carro principal"
Car Name="Nome do carro"
ScanMyTesla last received=ScanMyTesla recebeu pela última vez
Tasker Token=Ficha de Sacos
Tasker URL=URL dos sacos
Received Tasker Token=Ficha Tarefa Recebida

#Alle Verbräuche - ScanMyTesla.json
Alle Verbräuche - ScanMyTesla="Consumos Totais - ScanMyTesla"
Zelltemperatur [°C]=Temperatura das Células [°C]
Zelltemperatur [°F]=Temperatura das Células [°F]

#Trip Monatsstatistik.json
Datum=Data
Fahrzeit [h]=Tempo de Viagem [h]
Strecke [km]=Distância [km]
Strecke [mi]=Distância [mi]
Verbraucht [kWh]=Consumo [kWh]
Ø Verbrauch [kWh]=Ø Consumo [kWh]
Anzahl Trips=Número de Viagens
Trip Monatsstatistik=Estatísticas Mensais de Viagens
Zellspannungen 01-20 - ScanMyTesla="Voltagem das Células 01-20 - ScanMyTesla"
Zellspannungen 21-40 - ScanMyTesla="Voltagem das Células 21-40 - ScanMyTesla"
Zellspannungen 41-60 - ScanMyTesla="Voltagem das Células 41-60 - ScanMyTesla"
Zellspannungen 61-80 - ScanMyTesla="Voltagem das Células 61-80 - ScanMyTesla"
Zellspannungen 81-99 - ScanMyTesla="Voltagem das Células 81-99 - ScanMyTesla"
Ja=Sim
Nein=Não
Einschlafen=Adormecer
Automatic updates=Actualizações Automáticas
TextShare=<h1>Partilhar curvas de carregamento e degradação anonimamente</h1>Gostaríamos de criar uma base de dados anónima para comparar curvas de carregamento e de degradação das baterias. Isto permite que compare o seu veículo com outros a qualquer momento e detectar antecipadamente qualquer desvio fora do habitual. A funcionalidade também poderá ser usada para justificar o bom estado da bateria numa venda no future. Ou, em sentido contrário, poder provar junto da Tesla no caso de performance reduzida.<br><br>Gostaria de partilhar as suas curvas de carregamentos rápidos e curvas de degradação com outros utilizadores de Teslas de forma totalmente anónima? Esta decisão pode ser alterada a qualquer momento no ecrã de configuração.
StreamingPosHelp=<h1>Posição por StreamingAPI</h1>permite entradas de posição DB da API de streaming - dependendo da recepção do carro isto significa até 5 posições por segundo (em comparação com uma posição a cada cinco segundos no modo normal), isto aumentará muito o tamanho da sua base de dados, aumentará o desgaste no cartão SD e resultará em enormes cópias de segurança
Daten anonym teilen=Partilhar dados anonimamente
TextSuspendTeslalogger=O Teslalogger foi interrompido! Os dados não serão guardados!
Resume Teslalogger=Retomar o Teslalogger
Range=Autonomia

#abrp.php
ABRPTitle=Link do Abetterouteplanner
TextABRP=Você pode configurar um link do Teslalogger para o Abetterouteplanner para evitar fornecer suas credenciais da Tesla a terceiros. Outro benefício é minimizar a possibilidade de evitar que o carro adormeça se mais de um serviço estiver usando suas credenciais.
ABRP1=Criar uma conta Abetterouteplanner
ABRP2=Ir para Configurações
ABRP3="Escolha seu carro"
ABRP4="Salve seu carro em sua conta"
ABRP5="Dê um nome ao seu carro"
ABRP6=Clique em "Link Generic" para obter um token ABRP
ABRP7=Copie o token e clique em "Concluído"
ABRP8=Inserir o token no Teslalogger
ABRP9=Verifique se o Teslalogger está conectado
ABRPYT=Verifique o tutorial do YouTube para demonstração ao vivo
ABRPToken=Token Abetterouteplanner

#chargingcost.php
Charging Costs=Custos de Carregamento
Charger=Estação de carregamento
Date=Data
Charged=Carregado
Efficiency=Eficiência
Currency=Moeda
kWh according to meter/invoice=kWh de acordo com contador/factura
Cost per kWh=Custo por kWh
Cost per charge=Custo por Carregamento
Cost per minute=Custo por Minuto
Idle cost per minute=Custo de Ociosidade por Minuto
Total=Total
Ladesäule=Estação de Carregamento
Minutes=Acta

#wallbox.php
Wallbox=Wallbox
WallboxComment=Pode ligar o seu Teslalogger à sua Wallbox para calcular a eficiência de carregamento ou a percentagem de fotovoltaicos utilizados para carregar o seu carro.
Host=Host
Param=Param
Test=Teste
Type=Tipo
Info=Info
Version=Versão
Utility kWh=Utilitário kWh
Vehicle kWh=Veículo kWh

#mqtt.php
MQTTSettings=MQTT settings
MQTTSettingsInfo="MQTT Host is mandatory. All other settings are optional"
TopicStructure=Topic structure:
MQTT1="All values in one JSON (if activated): "_QQ_"teslalogger/json/CAR_VIN/currentjson"_QQ_""
MQTT2="All values as subtopics (if activated): "_QQ_"teslalogger/cars/CAR_VIN/ideal_battery_range_km"_QQ_""
MQTT3="teslalogger"_QQ_" is parametrizable in field "_QQ_"Topic"
MQTT4="CAR_VIN" is VIN of your car
MQTT5="ideal_battery_range_km" are single topics
ADDescription=AutoDiscovery:
MQTTAD1=""_QQ_"singletopics"_QQ_" are mandatory for AutoDiscovery!"
ControlTopic=Topic for control:
MQTT6="teslalogger/command/CAR_VIN/set_charge_limit" and "13" as RAW value
MQTT7=Supported commands
RebootAfterSave=Reboot TeslaLogger after save!
Host=Host
Port=Port
Topic=Topic
PublishJson="Publish JSON"
Singletopics=Publish single topics
ClientID=ClientID
AutoDiscovery=AutoDiscovery
AutoDiscoveryTopic=AutoDiscovery Topic

#superchargebingo.php
SuperChargeBingo=SuperChargeBingo
SuperChargeBingoComment=Pode configurar um link do TeslaLogger para o SuperChargeBingo para efectuar checkins automáticos nos Superchargers.
Create a SuperChargeBingo account=Criar uma conta SuperChargeBingo
Create API key (must be secure)=Criar chave API (deve ser segura)
Copy Username and API key and insert it in TeslaLogger=Copiar nome de utilizador e chave API e inseri-lo no TeslaLogger
Save and restart TeslaLogger=Guardar e reiniciar o TeslaLogger
Username=Nome de utilizador
API key=Chave API

#geoadd.php
Name & Position=Nome
Description=Descrição
Radius=Radius
Special Flags=Bandeiras especiais
Home=Início
Work=Trabalho
Copy Charging Costs=Custos de cobrança de cópias
Don't Combine Charging Sessions=Não Combine Sessões de Carregamento
Set Charge Limit=Definir Limite de Carga
SOC=SOC
Set on arrival=Preparar à chegada
Set Charge Limit After Charging=Definir o limite de carga após o carregamento
Open Charge Port=Porto de Carga Aberto
Gear=Equipamento
D → P=D → P
D/R → P=D/R → P
R → P=R → P
High Frequency Logging=Registo de Alta Frequência
Special Count=Contagem especial
Count=Conde
Special Features=Características especiais
Enable Sentry Mode="Activar o modo sentinela"
Disable Sentry Mode="Desactivar o modo sentinela"
Turn HVAC off=Desligar o AVAC
No sleep=Sem sono
Are you sure you want to delete this geofencing location?="Tem a certeza de que quer apagar este local de geofencing?"
Error=Erro
Deleted!=Apagado!
Meter=Metro

#journeys.php
Journeys=Jornadas
Journey name missing!=Falta o nome da viagem!
Please select=Por favor seleccione
Please select start point!=Por favor, seleccione o ponto de partida!
Please select end point!=Por favor, seleccione o ponto final!
TextJourneys=Pode utilizar viagens para combinar uma longa viagem / tempo e resumir todos os números. Isto é muito útil para acompanhar o tempo de carga completo de uma viagem longa ou para comparar o consumo de pneus de Verão ou de Inverno.
ID=ID
Journey=Viagem
Start address=Endereço de início
Target address=Endereço alvo
End=Fim
Consumed kWh=kWh consumido
Charged kWh=KWh carregado
Drive time [h]=Tempo de condução [h]
Charge time [h]=Tempo de carga [h]
Distance [mi]=Distância [mi]
Distance [km]=Distância [km]
Charging costs=Custos de tarifação
CO2 [kg]="CO₂ [kg]"
New Journey=Nova Viagem
Journey name=Nome da viagem
Please wait=Por favor aguarde
Please select start first=Por favor, seleccione começar primeiro
DelJourney="Quer mesmo apagar a viagem {id}?"
Display _MENU_ records per page=Mostrar _MENU_ registos por página
Nothing found=Nada foi encontrado
Showing _START_ to _END_ of _TOTAL_ entries=Mostrando _START_ a _END_ de _TOTAL_ entradas
No records available=Não há registos disponíveis
(filtered from _MAX_ total records)=(filtrado de _MAX_ registos totais)
Search=Pesquisa
First=Primeiro
Last=Último
Next=Próximo
Previous=Anterior

#adminpanelpassword.php
Please enter password!=Por favor introduza a palavra-passe!
Passwords do not match!=As palavras-passe não coincidem!
Do you want to delete your password?=Quer apagar a sua palavra-passe?
Set password for Teslalogger's admin panel=Definir senha para o painel de administração do Teslalogger
Name=Nome

#changelog.php
Changelog=Changelog

#dashboard.php
Dashboard=Painel de instrumentos

#logfile.php
Download Logfile=Descarregar ficheiro de registo
Lines=Linhas
Housekeeping=Administração doméstica
Update=Actualização
Sleep Attempt=Tentativa de Sono

#menu.php
Logfile=ficheiro de registo
Restart=Reiniciar
Dashboards=Painel de instrumentos
Fleet Statistic=Estatísticas da Frota
My Degradation=A Minha Degradação
My Charging AVG=O meu AVG de Carregamento
Fleet Degradation AVG=Degradação da Frota AVG
Fleet Charging AVG=Carregamento da Frota AVG
Fleet Charging MAX (Firmware)=Carregamento de Frota MAX (Firmware)
Fleet Charging Locations=Locais de carregamento da frota
Fleet Fast Charging Map=Mapa de Carregamento Rápido da Frota
Supercharger Usage=Utilização do Supercharger
Firmware Tracker=Rastreador de Firmware
Extras=Extras
Backup=Cópia de segurança
Restore=Restaurar
Geofence=Geofence
Abetterrouteplanner=Abetterrouteplanner
Wakeup Teslalogger=Teslalogger de despertar
Suspend Teslalogger=Teslalogger Suspenso

#ovms.php
Please enter your dexters-web.de account credentials=Por favor introduza as suas credenciais de dexters-web.de account
Dexter Login=Login de Dexter
Dexter Password=Palavra-passe Dexter

#password_info.php
Credentials Info=Informações de Credenciais

#restore.php
Restore Database=Restaurar base de dados
TextRestore1=Por favor, certifique-se de fazer uma cópia de segurança do seu Teslalogger antes de restaurar quaisquer bases de dados. Mova a sua pasta de cópia de segurança do Registo de Testemunhos de RASPBERRY para o seu disco rígido!
TextRestore2=O processo de restauração pode demorar até 10 minutos!
TextRestore3=Não interrompa o processo de restauração de forma alguma! Não recarregue a página! Não feche esta página!
