#Akku Trips.json
Akku Trips=充电行程
Start Trip=行程开始时间
End Trip=行程结束时间
Time=时间
StartSOC=初始SOC
EndSOC=最终SOC
SOC diff=SOC 差值
Start km=起始公里数
End km=最终公里数
Start mi=起始英里数
End mi=最终英里数
kmDiff=公里数差异
Max Range=最长续航里程
Ø Verbrauch=Ø 电量消耗
Tage=天数

#Degradation.json
Degradation=电池损耗
Maximalreichweite [km]=最长续航里程 [公里]
Maximalreichweite [mi]=最长续航里程 [英里]
km Stand [km]=里程表 [公里]
mi Stand [mi]=里程表 [英里]
Odometer [mi]=
Max. Reichweite (Monatsmittel) [km]=最大里程数 (月平均) [km]
Max. Reichweite (Monatsmittel) [mi]=最大里程数 (月平均) [mi]

#Ladehistorie.json
Ladehistorie=充电记录
Startdatum=起始时间
Enddatum=结束时间
geladen kWh=已充电数值(kWh）
km Stand=里程表
Adresse=地址
TR km Start=起始剩余公里数
TR km Ende=最终剩余公里数
SOC Ende=结束SOC
100% TR=100%续航里程
Minuten=分钟数
TR mi Start=起始剩余英里数
TR mi Ende=最终剩余英里数
ØkW=平均充电功率KW

#Ladestatistik.json
Ladestatistik=充电统计
Letzte Ladung=上一次充电时间
Ort=充电桩地址
Ø geladen kWh=平均冲电量（kWh）
Ladezeit h=总计充电时长（小时）
Ø SOC=平均SOC
Max SOC=最大SOC
Anzahl Ladungen=充电次数
Anzahl=次数
Geladen=已充电
Ladezeit=充电时长
Anz. Ladungen=次数
Ladehub=充电里程数

#SOC Ladestatistik.json
SOC Ladestatistik=SOC 充电统计
SOC [%]=SOC [%]

#Laden.json
Laden=充电
Ladespannung [V]=充电电压 [V]
Reichweite [mi]=里程 [英里]
Reichweite [km]=里程 [公里]
Leistung [kW]=功率 [kW]
Phasen=阶段
Stromstärke [A]=充电电流 [A]
Angefordert [A]=请求电流 [A]
Pilot [A]=试点 [A]

#Vampir Drain Monatsstatistik.json
Vampir Drain Monatsstatistik=电量流失 月统计
TR mi Verlust=里程英里数流失
kWh Verlust=kWh流失
Eur Verlust=流失电量金额

#Trip.json
Trip=行程
Start=起始时间
Ende=终止时间
Start Adresse=起始地址
Ziel Adresse=目的地地址
Ø Verbrauch kWh=平均消耗 kWh
Verbraucht kWh=已消耗 kWh
Dauer Min=时长分钟
mi=英里数
km=公里数
Ø °C=平均温度°C
Ø °F=平均温度°F
max mph=最大时速（英里）
max km/h=最大时速（公里）
max PS=最大 HP
min PS=最小 HP
max kW=最大 kW
min kW=最小 kW
Ø PS=Ø HP
Ø kW=Ø kW
Ø mph=平均时速（英里）
Ø km/h=平均时速（公里）

#Vampir Drain Monatsstatistik.json
Zeitspanne Stunden=时间段 小时
TR mi Verlust pro Stunde=TR 每小时里程流失英里数
mi Stand=里程表

#Vampir Drain.json
Vampir Drain=电量流失
Standby Stunden=待机小时数
Standby=待机
TR km Verlust=里程流失公里数
TR km Verlust pro Stunde=TR 每小时里程流失公里数

#Verbrauch.json
Verbrauch=电量消耗
Höhe [m]=海拔高度 [m]
Altitude [m]=海拔高度 [m]
Geschwindigkeit [mph]=速度 [英里每小时]
Geschwindigkeit [km/h]=速度 [公里每小时]
Leistung [PS]=最大功率 [HP]
Außentemperatur [°C]=车外温度 [°C]
Außentemperatur [°F]=车外温度 [°F]
Innentemperatur [°C]=车内温度 [°C]
Innentemperatur [°F]=车内温度 [°F]

Laden fertig=充电已完成
Schlafen=休眠
Online=在线

#Visited.json
Visited=行驶轨迹记录

#index.php
Fahrzeuginfo=车辆信息
Status=状态
Typical Range=典型续航里程
KM Stand=里程表
Car Version=车辆版本
Letzter Trip=上一次行程
Dauer=时长
Distanz=距离
Max km/h=最大速度（公里每小时）
PS=PS
Current Pos=当前位置
Last Update=上一次更新
Wird geladen=充电
Done=完成
Done at=完成时间
Battery Heater=电池加热器
Sentry Mode=哨兵模式
Preconditioning=预处理
Offline=离线

#menu.php
Logfile=日志
Restart=重启
Update=升级
Dashboards=仪表盘
Fleet Statistic=车队统计
Extras=附加功能
Settings=设置
Backup=备份
Restore=还原
Geofence=电子围栏
Suspend Teslalogger=暂停 Teslalogger
Wakeup Teslalogger=唤醒 Teslalogger
Dashboard=仪表盘

#password.php
Teslalogger Tesla Zugangsdaten=Teslalogger Tesla 账号信息
Bitte Tesla Account Zugangsdaten eingeben=请输入Tesla账号信息
Email=邮箱地址
Passwort=密码
Passwort wiederholen=再次输入密码
Speichern=保存

#settings.php
Zugangsdaten=账号信息设置
Language=语言
Leistung=功率
Temperatur=温度
Längenmaß=长度单位
URL Admin Panel=管理页面网址
All=全部
Stable=稳定
None=空
Enable=开启
Celsius=摄氏度
Fahrenheit=华氏度
URL Grafana=Grafana网址
Teslalogger HTTP Port=Teslalogger HTTP 端口
Zoom Level=缩放级别
ScanMyTesla integration=集成ScanMyTesla
Main Car=主要车辆
Car Name=车辆名字
ScanMyTesla last received=ScanMyTesla上一次接收时间
Tasker Token=Tasker令牌
Tasker URL=Tasker 网址
Received Tasker Token=已接收Tasker令牌

#geoadd.php
Bezeichnung=描述

#Alle Verbräuche - ScanMyTesla.json
Alle Verbräuche - ScanMyTesla=All 电量消耗 - ScanMyTesla
Zelltemperatur [°C]=电池温度 [摄氏度]
Zelltemperatur [°F]=电池温度 [华氏度]

#Trip Monatsstatistik.json
Datum=日期
Fahrzeit [h]=驾驶时长 [小时]
Strecke [km]=距离 [公里]
Strecke [mi]=距离 [英里]
Verbraucht [kWh]=已消耗 kWh
Ø Verbrauch [kWh]=平均电量消耗 kWh
Anzahl Trips=行程计数
Trip Monatsstatistik=行程月统计

Zellspannungen 01-20 - ScanMyTesla=电池电压 01-20 - ScanMyTesla
Zellspannungen 21-40 - ScanMyTesla=电池电压 21-40 - ScanMyTesla
Zellspannungen 41-60 - ScanMyTesla=电池电压 41-60 - ScanMyTesla
Zellspannungen 61-80 - ScanMyTesla=电池电压 61-80 - ScanMyTesla
Zellspannungen 81-99 - ScanMyTesla=电池电压 81-99 - ScanMyTesla

Ja=是
Nein=否

Einschlafen=进入休眠
Automatische Updates=自动更新

TextShare=<h1>匿名共享充电与电池损耗曲线</h1>我们希望建立一个充电与电池损耗的数据库.便于让用户对比参考，及时发现自己车辆与平均值的异常偏离.这个数据也可以作为车辆二手交易时，电池续航能力良好的证明. 也可以用于向Tesla证明自己车辆性能的下降。<br><br>你是否愿意匿名共享充电与电池损耗曲线给其他Tesla用户？这个设置可以在设置页面随时进行变更.
Daten anonym teilen=匿名共享数据
TextSuspendTeslalogger=Teslalogger已停止！数据将不会被记录！
Resume Teslalogger=继续Teslalogger
Reichweite=里程

Ladekosten=充电成本
Ladesäule=充电站
Währung=货币
Kosten pro kWh=每度电计价
Kosten pro Ladung=单次充电计价
Kosten pro Minute=每分钟充电计价
Kosten Blockiergebühr=充电超时计价
Summe=汇总
kWh laut Zähler / Rechnung=计价表千瓦时数 / 收据
Wirkungsgrad=效率
