#Allgemein
Delete=Uitwissen
Save=Opslaan
Settings=Instellingen
Setup=Opstelling
Enabled="Ingeschakeld"
kWh=kWh

#Akku Trips.json
Akku Trips=Accu ritten
Start Trip=Start rit
End Trip=Einde rit
Time=Datum
StartSOC=StartSOC
EndSOC=EindeSOC
SOC diff=SOC verschil
Start km=Start km
End km=Einde km
Start mi=Start mi
End mi=Einde mi
kmDiff=kmVerschil
Max Range=Max Bereik
Ø Verbrauch=Ø Verbruik
Tage=Dagen

#Degradation.json
Degradation=Degredatie
Maximalreichweite [km]=Max Bereik [km]
Maximalreichweite [mi]=Max Bereik [mi]
km Stand [km]=Kilometerteller [km]
mi Stand [mi]=Kilometerteller [mi]
Odometer [mi]="kilometerteller"
Max. Reichweite (Monatsmittel) [km]=Max Bereik (maandelijks gem.) [km]
Max. Reichweite (Monatsmittel) [mi]=Max Rage (maandelijks gem.) [mi]

#Ladehistorie.json
Ladehistorie=Laadhistorie
Startdatum=Startdatum
Enddatum=Einddatum
geladen kWh=kWh geladen
km Stand=Kilometerteller
Adresse=Adres
TR km Start=TR km Start
TR km Ende=TR km Einde
SOC Ende=SOC Einde
100% TR=100% TR
Minuten=Minuten
TR mi Start=TR mi Start
TR mi Ende=TR mi Einde
ØkW=ØkW

#Ladestatistik.json
Ladestatistik=Laadstatistieken
Letzte Ladung=Laatst laadbeurt
Ort=Locatie
Ø geladen kWh=Ø Geladen kWh
Ladezeit h=Laadtijd h
Ø SOC=Ø SOC
Max SOC=Max SOC
Anzahl Ladungen=Aantal maal geladen
Anzahl=Aantal
Geladen=Geladen
Ladezeit=Laadtijd
Anz. Ladungen=Aantal
Ladehub=Bereik na laden

#SOC Ladestatistik.json
SOC Ladestatistik=SOC Laadstatistieken
SOC [%]=SOC [%]

#Laden.json
Laden=Laden
Ladespannung [V]=Laadvoltage [V]
Reichweite [mi]=Bereik [mi]
Reichweite [km]=Bereik [km]
Leistung [kW]=Vermogen [kW]
Phasen=Fasen
Stromstärke [A]=Huidig [A]
Angefordert [A]=Gevraagd [A]
Pilot [A]=Pilot [A]

#Vampir Drain Monatsstatistik.json
Vampir Drain Monatsstatistik=Vampire Drain Maandelijkse statistieken
TR mi Verlust=TR mi Verloren
kWh Verlust=kWh Verloren
Eur Verlust=Eur Verloren
Zeitspanne Stunden=Tijdspanne uren
TR mi Verlust pro Stunde=TR mi Verloren per uur
mi Stand=Kilometerteller

#Trip.json
Trip=Trip
Start=Start
Ende=Einde
Start Adresse=Start adres
Ziel Adresse=Bestemming adres
Ø Verbrauch kWh=Ø Verbruik kWh
Verbraucht kWh=Verbruik kWh
Dauer Min=Duur Min
mi=mi
km=km
Ø °C=Ø °C
Ø °F=Ø °F
max mph=Max mph
max km/h=max km/h
max PS=Max PK
min PS=Min PK
max kW=max kW
min kW=min kW
Ø PS=Ø PK
Ø kW=Ø kW
Ø mph=Ø mph
Ø km/h=Ø km/h

#Vampir Drain.json
Vampir Drain=Vampire Drain
Standby Stunden=Standby Uren
Standby=Standby
TR km Verlust=TR km Verloren
TR km Verlust pro Stunde=TR km Verloren per uur

#Verbrauch.json
Verbrauch=Verbruik
Höhe [m]=Hoogte [m]
Altitude [m]=Hoogte [m]
Geschwindigkeit [mph]=Snelheid [mph]
Geschwindigkeit [km/h]=Snelheid [km/h]
Leistung [PS]=Power [PK]
Außentemperatur [°C]=Buitentemperatuur [°C]
Außentemperatur [°F]=Buitentemperatuur [°F]
Innentemperatur [°C]=Binnentemperatuur [°C]
Innentemperatur [°F]=Binnentemperatuur [°F]
Laden fertig=Laden voltooid
Schlafen=Slapen
Online=Online

#Visited.json
Visited=Bezocht

#index.php
Car Info="Voertuig informatie"
Status=Status
Typical Range=Gemiddeld bereik
Odometer=Kilometerteller
Car Version=Auto versie
Last Trip=Laatste rit
Duration=Duur
Distance=Afstand
Max km/h="Max km/h"
PS=PK
Current Pos=Huidige positie
Last Update=Laatste update
Charging=Bezig met laden
Done=Gedaan
Done at=Klaar om
Battery Heater=Batterijverwarmer
Sentry Mode=Sentry Mode
Preconditioning=Voorconditionering
Offline=Offline
Falling asleep=In slaap vallen
Driving=Rijden
Sleeping=Slapen
kW=kW
OK=OK
No=Geen
Yes=Ja
Cell Temp=Cel Temp
Max Charge=Maximale lading
Max Discharge=Maximale ontlading
Cell Imbalance=Cel onbalans
Software Update=Software-update
Consumption=Verbruik
Ø Consumption="Ø Verbruik"
min=min
Wh/km=Wh/km
km/h=km/h
Please update to latest docker-compose.yml file. Check: {LINK}=Update naar het laatste docker-compose.yml bestand. Controleer: {LINK}

#menu.php
Logfile=Logbestand
Restart=Herstarten
Update=Bijwerken
Dashboards=Dashboards
Fleet Statistic=Vlootstatistiek
Extras=Extra's
Backup=Back-up
Restore=Herstellen
Geofence=Geofence
Suspend Teslalogger=Teslalogger opschorten
Wakeup Teslalogger=Teslalogger wakker maken
My Degradation=Mijn aftakeling
My Charging AVG=Mijn opladen AVG
Fleet Degradation AVG=Vlootafbraak AVG
Fleet Charging AVG=Vloot Opladen AVG
Fleet Charging MAX (Firmware)=Vloot Opladen MAX (Firmware)
Fleet Charging Locations=Vloot oplaadlocaties
Fleet Fast Charging Map=Vloot snelladen kaart
Supercharger Usage=Supercharger gebruik
Firmware Tracker=Firmware Tracker
Abetterrouteplanner=Abetterrouteplanner

#password.php
Teslalogger Tesla Credentials=Teslalogger Tesla Inloggegevens
Please enter your Tesla account credentials=Voer altublieft de toegangsgegevens van uw Tesla account in
Email="Email"
Password=Wachtwoord
Repeat Password=Wachtwoord herhalen
Speichern=Opslaan
Please enter the access token!=Voer het toegangstoken in!
Please enter the refresh token!=Voer het refresh token in!
Please select a vehicle=Selecteer een voertuig
Check Logfile!=Controleer het logboek!
Do you really want to delete this vehicle?="Wil je dit voertuig echt verwijderen?"
Check Logfile in one minute!=Controleer Logfile in één minuut!
Unauthorized=Onbevoegde
This isn't a valid URL!="Dit is geen geldige URL!"
This isn't an auth link by Tesla!=Dit is geen auth link van Tesla!
The URL doesn't contain the expected format!="De URL bevat niet het verwachte formaat!"
BA_Browser=In lokale {browser} (aanbevolen)
BA_Read=Lees alle stappen voordat u verder gaat:
BA_Logon=Klik op de onderstaande link <b>Tesla Logon</b> die een nieuw tabblad/venster zal openen voor de Tesla Authentication logon pagina.
BA_Auth=Log in met uw Tesla referenties en MFA indien nodig (Tesla zal deze onthouden als u de link eerder hebt gebruikt).
BA_NotFound=Dit lijkt te resulteren in een "Page Not Found". Dit is normaal.
BA_URL="Kopieer de resulterende URL van die webpagina in het onderstaande formulier. In de URL staat een eenmalige, tijdelijke code die we kunnen gebruiken om tokens te genereren. Wij zullen deze voor u uit de link halen."
BA_Invalid=Deze links werken meestal maar één keer, dus als er een "Invalid Grant" of andere foutmelding verschijnt op onze website moet u wellicht opnieuw beginnen met de Tesla Logon link die een nieuwe link zou moeten opleveren.
BA_Logoff=Als u een ander account wilt gebruiken, moet u zich handmatig afmelden.
BA_GetToken="Wij krijgen dan de tokens voor uw Tesla account."
BA_SelectCar="Selecteer de auto die u wilt gebruiken voor Teslalogger."
BA_Step1=Step 1:
BA_Step2=Step 2:
BA_Step3=Stap 3:
BA_FillOut=Vul dit formulier in:
BA_CopyUrl="Kopieer de resulterende URL zoals weergegeven"
BA_Paste="Plak de resulterende URL in het vak en klik op de "_QQ_"Tokens krijgen"_QQ_" knop:"
Get Tokens=Tokens krijgen
Access Token=Toegangstoken
Refresh Token=Refresh Token
Car="Auto"
Free Supercharging=Gratis opladen
Reconnect=Sluit  opnieuw aan.
Please choose your vehicle=Kies uw voertuig
Model=Model
VIN=VIN
Free SUC=Gratis SUC
Edit=Bewerk
New car="Nieuwe auto"

#settings.php
Credentials=Inloggegevens
Language=Taal
Power=Prestaties
Temperatur=Temperatuur
Unit of length=Lengte-eenheid
URL Admin Panel=URL Admin omgeving
Saved!=Gered!
MyTesla=MyTesla
Teslalogger Adminpanel=Teslalogger Admin paneel
Temperature=Temperatuur
Celsius=Celsius
Fahrenheit=Fahrenheit
mile=mijl
Ideal=Ideaal
Rated=Gewaardeerd
Share data anonymously=Gegevens anoniem delen
Enable="Schakel  in."
All=Alle
Stable=Stabiel
None=Geen
Sleep=Slaap
to=naar
Show calc. 100% range=Toon calc. 100% bereik
URL Grafana=URL Grafana
Teslalogger HTTP Port=Teslalogger HTTP-poort
Zoom Level=Zoom Level
ScanMyTesla integration=ScanMyTesla integratie
Position by StreamingAPI=Positie door StreamingAPI
Main Car="Hoofdwagen"
Car Name="Naam auto"
ScanMyTesla last received=ScanMyTesla ontving laatst
Tasker Token=Tassen Penning
Tasker URL=Tassen URL
Received Tasker Token=Ontvangen Tasker Token

#Alle Verbräuche - ScanMyTesla.json
Alle Verbräuche - ScanMyTesla="Alle verbruik - ScanMyTesla"
Zelltemperatur [°C]=Cell Temperatuur [°C]
Zelltemperatur [°F]=Cell Temperatuur [°F]

#Trip Monatsstatistik.json
Datum=Date
Fahrzeit [h]=Rijtijd [h]
Strecke [km]=Afstand [km]
Strecke [mi]=Afstand [mi]
Verbraucht [kWh]=Verbruikt kWh
Ø Verbrauch [kWh]=Ø Verbruikt kWh
Anzahl Trips=Aantal ritten
Trip Monatsstatistik=Maandelijkse statistieken ritten
Zellspannungen 01-20 - ScanMyTesla="Celspanning 01-20 - ScanMyTesla"
Zellspannungen 21-40 - ScanMyTesla="Celspanning 21-40 - ScanMyTesla"
Zellspannungen 41-60 - ScanMyTesla="Celspanning 41-60 - ScanMyTesla"
Zellspannungen 61-80 - ScanMyTesla="Celspanning 61-80 - ScanMyTesla"
Zellspannungen 81-99 - ScanMyTesla="Celspanning 81-99 - ScanMyTesla"
Ja=Ja
Nein=Nee
Einschlafen=In slaap vallen
Automatic updates=Automatiske oppdateringer
TextShare=<h1>Share charge curves / degradation curves anonymously</h1>We would like to create an anonymous database to compare degradation curves and charge curves. This allows you to compare your vehicle with others at any time and to detect any unusual deviation at an early stage. This can also be used later to prove during the sales talk that your battery is still fully efficient. In the negative case, you can more easily prove a reduced performance against Tesla Motors.<br><br>Would you like to share your fast charging curves and degradation curves with other Tesla drivers completely anonymously? This decision can be changed at any time in the settings screen.
StreamingPosHelp=<h1>Positie door StreamingAPI</h1>maakt positie DB-items van de streaming API mogelijk - afhankelijk van de ontvangst van de auto betekent dit tot 5 posities per seconde (vergeleken met één positie om de vijf seconden in de normale modus), dit zal de grootte van uw database aanzienlijk vergroten, de SD-kaart meer belasten en resulteren in enorme back-ups.
Daten anonym teilen=Data anoniem delen
TextSuspendTeslalogger=Teslalogger is gestopt! De gegevens worden niet gelogd!
Resume Teslalogger=Start Teslalogger
Range=Bereik
TeslaAuthApps="You can use following apps to get an access token & refresh token from Tesla server:"

#abrp.php
ABRPTitle=Abetterrouteplanner Link
TextABRP=U kunt een link van Teslalogger naar Abetterrouteplanner instellen om te voorkomen dat u uw Tesla-referenties aan een derde partij geeft. Een ander voordeel is het minimaliseren van de mogelijkheid om te voorkomen dat de auto in slaap valt als meer dan één service uw inloggegevens gebruikt.
ABRP1=Maak een Abetterrouteplanner-account aan
ABRP2=Ga naar Instellingen
ABRP3="Kies uw auto"
ABRP4="Sla uw auto op in uw account"
ABRP5="Geef uw auto een naam"
ABRP6=Klik op "Link Generic" om een ABRP-token te krijgen
ABRP7=Kopieer de token en klik op "Gereed"
ABRP8=Plaats het token in Teslalogger
ABRP9=Controleer of de Teslalogger is aangesloten
ABRPYT=Bekijk YouTube-tutorial voor live demo
ABRPToken=Abetterrouteplanner-token

#chargingcost.php
Charging Costs=Laadkosten
Date=Datum
Charged=Opgeladen
Minutes=Minuten
Efficiency=Efficiëntie
Currency=Valuta
kWh according to meter/invoice=kWh volgens meter/factuur
Cost per kWh=Kosten per kWh
Cost per charge=Kosten per lading
Cost per minute=Kosten per minuut
Idle cost per minute=Kosten blokkeringsvergoeding
Total=Totaal

#wallbox.php
Wallbox=Wallbox
WallboxComment=U kunt uw Teslalogger aansluiten op uw Wallbox om het rendement van het opladen of het percentage fotovoltaïsche energie dat wordt gebruikt om uw auto op te laden, te berekenen.
Host=Host
Param=Param
Test=Test
Type=Type
Info=Info
Version=Version
Utility kWh=Utility kWh
Vehicle kWh=Vehicle kWh

#mqtt.php
MQTTSettings=MQTT settings
MQTTSettingsInfo="MQTT Host is mandatory. All other settings are optional"
TopicStructure=Topic structure:
MQTT1="All values in one JSON (if activated): "_QQ_"teslalogger/json/CAR_VIN/currentjson"_QQ_""
MQTT2="All values as subtopics (if activated): "_QQ_"teslalogger/cars/CAR_VIN/ideal_battery_range_km"_QQ_""
MQTT3="teslalogger"_QQ_" is parametrizable in field "_QQ_"Topic"
MQTT4="CAR_VIN" is VIN of your car
MQTT5="ideal_battery_range_km" are single topics
ADDescription=AutoDiscovery:
MQTTAD1=""_QQ_"singletopics"_QQ_" are mandatory for AutoDiscovery!"
ControlTopic=Topic for control:
MQTT6="teslalogger/command/CAR_VIN/set_charge_limit" and "13" as RAW value
MQTT7=Supported commands
RebootAfterSave=Reboot TeslaLogger after save!
Host=Host
Port=Port
Topic=Topic
PublishJson="Publish JSON"
Singletopics=Publish single topics
ClientID=ClientID
AutoDiscovery=AutoDiscovery
AutoDiscoveryTopic=AutoDiscovery Topic

#superchargebingo.php
SuperChargeBingo=SuperChargeBingo
SuperChargeBingoComment=U kunt een link instellen van TeslaLogger naar SuperChargeBingo om automatisch in te checken bij Superchargers.
Create a SuperChargeBingo account=Maak een SuperChargeBingo account aan
Create API key (must be secure)=API-sleutel aanmaken (moet veilig zijn)
Copy Username and API key and insert it in TeslaLogger=Kopieer gebruikersnaam en API sleutel en plaats deze in TeslaLogger
Save and restart TeslaLogger=TeslaLogger opslaan en opnieuw opstarten
Username=Gebruikersnaam
API key=API sleutel

#geoadd.php
Name & Position=Naam
Description=Beschrijving
Radius=Radius
Special Flags=Speciale vlaggen
Home=Home
Work=Werk
Charger=Lader
Copy Charging Costs=Kosten van kopieën
Don't Combine Charging Sessions=Oplaadsessies niet combineren
Set Charge Limit=Laadlimiet instellen
SOC=SOC
Set on arrival=Ingesteld bij aankomst
Set Charge Limit After Charging=Laadlimiet instellen na het laden
Open Charge Port=Open Laadpoort
Gear=Versnelling
D → P=D → P
D/R → P=D/R → P
R → P=R → P
High Frequency Logging=Hoogfrequent loggen
Special Count=Speciale telling
Count=Graaf
Special Features=Speciale kenmerken
Enable Sentry Mode="Schildwachtmodus inschakelen"
Disable Sentry Mode="Schildwachtmodus uitschakelen"
Turn HVAC off=Zet HVAC uit
No sleep=No sleep
Are you sure you want to delete this geofencing location?="Weet je zeker dat je deze geofencing locatie wilt verwijderen?"
Error=Fout
Deleted!=Verwijderd!
Meter=Meter

#journeys.php
Journeys=Reizen
Journey name missing!=Reisnaam ontbreekt!
Please select=Selecteer alstublieft
Please select start point!=Kies een startpunt!
Please select end point!=Selecteer het eindpunt!
TextJourneys=U kunt ritten gebruiken om een lange reis/tijd te combineren en alle getallen samen te vatten. Dit is zeer nuttig om de volledige laadtijd van een lange reis bij te houden of om het verbruik van zomer- of winterbanden te vergelijken.
ID=ID
Journey=Reis
Start address=Startadres
Target address=Doeladres
End=Einde
Consumed kWh=Verbruikte kWh
Charged kWh=Opgeladen kWh
Drive time [h]=Rijtijd [h]
Charge time [h]=Laadtijd [h]
Distance [mi]=Afstand [mi]
Distance [km]=Afstand [km]
Charging costs=Oplaadkosten
CO2 [kg]="CO₂ [kg]"
New Journey=Nieuwe reis
Journey name=Naam van de reis
Please wait=Wacht even.
Please select start first=Selecteer eerst start
DelJourney="Wil je echt reis {id} verwijderen?"
Display _MENU_ records per page=Geef _MENU_ records per pagina weer
Nothing found=Niets gevonden.
Showing _START_ to _END_ of _TOTAL_ entries=Weergave van _START_ tot _END_ van _TOTAL_ inzendingen
No records available=Geen gegevens beschikbaar
(filtered from _MAX_ total records)=(gefilterd uit _MAX_ totale records)
Search=Zoek op
First=Eerst
Last=Laatste
Next=Volgende
Previous=Vorige

#adminpanelpassword.php
Please enter password!=Voer het wachtwoord in!
Passwords do not match!=Wachtwoorden komen niet overeen!
Do you want to delete your password?=Wilt u uw wachtwoord wissen?
Set password for Teslalogger's admin panel=Wachtwoord instellen voor het beheerderspaneel van de Teslalogger
Name=Naam

#changelog.php
Changelog=Changelog

#dashboard.php
Dashboard=Dashboard

#logfile.php
Download Logfile=Logbestand downloaden
Lines=Lijnen
Housekeeping=Huishouding
Sleep Attempt=Slaappoging

#ovms.php
Please enter your dexters-web.de account credentials=Voer uw dexters-web.de accountgegevens in.
Dexter Login=Dexter Inloggen
Dexter Password=Dexter Wachtwoord

#password_info.php
Credentials Info=Informatie over geloofsbrieven

#restore.php
Restore Database=Database herstellen
TextRestore1=Zorg ervoor dat u een back-up maakt van uw Teslalogger voordat u databases herstelt. Verplaats de map met back-ups van de Teslalogger naar uw harde schijf!
TextRestore2=Het herstelproces kan tot 10 minuten duren!
TextRestore3=Onderbreek het herstelproces op geen enkele manier! Herlaad de pagina niet! Sluit deze pagina niet!
