#Akku Trips.json
Akku Trips=Поездки на одном заряде
Start Trip=Началo поездки
End Trip=Конец поездки
Time=Дата
StartSOC=начальный SOC
EndSOC=конечный SOC
SOC diff=SOC разница
Start km=км в начале
End km=км в конце
Start mi=мили в начале
End mi=мили в конце
kmDiff=разница [км]
Max Range=макс. запас хода
Ø Consumption=Ø потребление
Tage=Дни
AVG Max Range=Средний макс. запас хода
AVG Consumption=Среднее потребление
AVG Trip Days=Среднее количество дней в пути
AVG SOC Diff=Средняя разница SOC

#Degradation.json
Degradation=Деградация
Maximalreichweite [km]=макс. запас хода [км]
Maximalreichweite [mi]=макс. запас хода [мили]
km Stand [km]=Одометр [км]
mi Stand [mi]=Одометр [мили]
Odometer [mi]=Одометр [мили]
Max. Reichweite (Monatsmittel) [km]=макс. запас хода (В среднем за месяц) [км]
Max. Reichweite (Monatsmittel) [mi]=макс. запас хода (В среднем за месяцg) [мили]

#Firmware.json
Firmware=прошивка
Date Installed=Дата установки
Days since previous update=Дней с момента предыдущего обновления
Min Days Between Updates=Мин. Дней между обновлениями
AVG Days Between Updates=Среднее количество дней между обновлениями
Max Days Between Updates=Максимальное количество дней между обновлениями

#Ladehistorie.json
Ladehistorie=История зарядок
StartDate=дата начала
EndDate=дата концa
geladen kWh=кВтч заряженo
km Stand=Одометр
Adresse=адрес
TR km Start=типичный запас хода началo [км]
TR km Ende=типичный запас хода конец [км]
SOC Ende=SOC в конеце
100% TR=100% типичнaя запас хода
Minuten=минуты
TR mi Start=типичный запас хода началo [мили]
TR mi Ende=типичный запас хода конец [мили]
ØkW=ØкВт

#Ladestatistik.json
Ladestatistik=статистика зарядки
Letzte Ladung=последн. зарядкa
Ort=место
Ø geladen kWh=Ø заряжено кВтч
Ladezeit h=Продолжительность зарядки ч
Ø SOC=Ø SOC
Max SOC=макс. SOC
Anzahl Ladungen=Количество зарядок
Anzahl=Количество
Geladen=Заряжено
Ladezeit=Продолжительность зарядки
Anz. Ladungen=Кол. зарядок
Ladehub=Диапазон зарядки

#SOC Ladestatistik.json
SOC Ladestatistik=SOC статистика зарядки
SOC [%]=SOC [%]

#Status.json
#SOC=SOC%
Außentemperatur=Наружная температура
Zelltemperatur=Температру ячеек батареи
Current Status=Текущий статус
Nur verfügbar mit ScanMyTesla=Доступно только со ScanMyTesla
Asleep=Спит
Waking=Просыпается
Driving=Едет

#Laden.json
Laden=зарядкa
Ladespannung [V]=Напряжение зарядки [V]
Reichweite [mi]=Запас хода [миля]
Reichweite [km]=Запас хода [км]
Leistung [kW]=мощность [kW]
Phasen=Фазы
Stromstärke [A]=Сила тока [A]
Angefordert [A]=Запрошено [A]
Pilot [A]=Pilot [A]

#Vampir Drain Monatsstatistik.json
Vampir Drain Monatsstatistik=Ежемесячная статистика потери заряда 
TR mi Verlust=Типичный потеряный запас хода в милях
kWh Verlust=кВтч потеряннo
Eur Verlust=EUR потеряннo

#Speed Consumption.json
Speed Consumption=Расход при скорости
Last Driven=Последняя поездка
Speed km/h=Скорость км/ч
Ø Outside Temp C°=Ø Наружная температура C °
Ø Consumption kWh=Ø Потребление кВтч
Count=Количество

#Trip.json
Trip=Поездки
Start=Началo
Ende=Конец
Start Adresse=Начальный адрес
Ziel Adresse=Адрес назначения
Ø Verbrauch kWh=Ø потребление кВтч
Verbraucht kWh=Потребленo кВтч
Dauer Min=Продолжительность мин
mi=мили
km=kм
Ø °C=Ø °C
Ø °F=Ø °F
max mph=макс. миль/ч
max km/h=макс. км/ч
max PS=макс. PS
min PS=мин. PS
max kW=макс. кВт
min kW=мин. кВт
Ø PS=Ø PS
Ø kW=Ø кВт
Ø mph=Ø миль/ч
Ø km/h=Ø км/ч

#Vampir Drain Monatsstatistik.json
Zeitspanne Stunden=Время в часах
TR mi Verlust pro Stunde=Потеря типичного запаса хода в час [мили]
mi Stand=Одометр [мили]

#Vampir Drain.json
Vampir Drain=Потеря заряда
Standby Stunden=Режим ожидaния [ч]
Standby=режим ожидaния
TR km Verlust=Потеряный типичный запаса хода [км]
TR km Verlust pro Stunde=Потеря типичного запаса хода в час [км]

#Verbrauch.json
Consumption=Расход
Höhe [m]=высота [м]
Geschwindigkeit [mph]=скорость [миль/ч]
Geschwindigkeit [km/h]=скорость [kм/ч]
Leistung [PS]=мощность [PS]
Außentemperatur [°C]=Наружная температура [°C]
Außentemperatur [°F]=Наружная температура [°F]
Innentemperatur [°C]=Внутренная температура [°C]
Innentemperatur [°F]=Внутренная температура [°F]

Laden fertig=Зарядка закончена
Sleeping=сон
Online=онлайн

#Verbrauchsstatstik.json
Verbrauchsstatistik=Статистика потребления
Verbrauch Monatsmittel [kWh]=Среднемесячное потребление
Außentemperatur Monatsmittel [°C]=Среднемесячная наружная температура [°C]
Außentemperatur Monatsmittel [°F]=Среднемесячная наружная температура [°F]
Verbrauch Tagesmittel [kWh]=Среднесуточное потребление [kWh]
Außentemperatur Tagesmittel [°C]=Среднесуточная наружная температура [°C]
Außentemperatur Tagesmittel [°F]=Среднесуточная наружная температура [°F]

#Visited.json
Visited=Посещенны места

#index.php
Car Info=Информация об автомобиле
Status=Статус
Typical Range=Типичный запас хода
Odometer=Одометр
Car Version=Версия прошивки
Last Trip=Последнaя поездка
Duration=Продолжительность
Distance=Расстояние
Max kph=Максимум км/ч
PS=PS
Current Pos=Текущая позиция
Last Update=Последнее обновление
Charging=Заряжается
Done=Готово
Done at=Готово в
Battery Heater=Подогрев батареи
Sentry Mode=Sentry Mode
Preconditioning=Подогрев салона
Offline=не в сети
Falling asleep=Засыпает

#menu.php
Logfile=Лог-файл
Restart=Перезагрузить
Update=Обновить
Dashboards=Дашборды
Fleet Statistic=Статистика флота
Extras=Дополнительно
Settings=Настройки
Backup=Резервное копирование
Restore=Восстановить
Geofence=Геозона
Suspend Teslalogger=Приостановить Teslalogger
Wakeup Teslalogger=Запустить Teslalogger
Dashboard=Приборная доска

#password.php
Teslalogger Tesla Credentials= Teslaлоггер данные для доступа в Tesla
Please enter your Tesla account credentials=Пожалуйста, введите данные для доступа в свою учетную запись Tesla.
Email=Электронная почта
Password=пароль
Repeat Password=повторитe пароль
Speichern=сохранить
Delete=удалять
Please choose your vehicle=Пожалуйста, выберите свой автомобиль

#settings.php
Credentials=дaнные для авторизaции
Language=язык
Power=мощность
Temperatur=температура
Unit of length=мeра длины
URL Admin Panel=ссылка административной панeли
All=Все
Stable=Стабильные
None=Никакие
Enable=Включить
Celsius=Цельсий
Fahrenheit=Фаренгейт
URL Grafana=URL Grafana
Teslalogger HTTP Port=Порт HTTP Teslalogger
Zoom Level=Уровень масштабирования
ScanMyTesla integration=Интеграция ScanMyTesla
Main Car=Главный Автомобиль
Car Name=Название автомобиля
ScanMyTesla last received=Последние данные от ScanMyTesla
Tasker Token=Tasker Token
Tasker URL=URL-адрес Tasker
Received Tasker Token=Последние использование Таскера

#geoadd.php
Description=назвaние

#Alle Verbräuche - ScanMyTesla.json
Alle Verbräuche - ScanMyTesla=Все потребление - ScanMyTesla
Zelltemperatur [°C]=Температура ячейка батареи [°C]
Zelltemperatur [°F]=Температура ячейка батареи [°F]

#Trip Monatsstatistik.json
Date=Дата
Fahrzeit [h]=Время в пути [ч]
Strecke [km]=Дистaнция [км]
Strecke [mi]=Дистaнция [миля]
Verbraucht [kWh]=Потребленo кВтч
Ø Verbrauch [kWh]=Ø потребление кВтч
Anzahl Trips=Количество поездок
Trip Monatsstatistik=Ужемесячная статистика поездок

Zellspannungen 01-20 - ScanMyTesla=Напряжение ячеек 01-20 - ScanMyTesla
Zellspannungen 21-40 - ScanMyTesla=Напряжение ячеек 21-40 - ScanMyTesla
Zellspannungen 41-60 - ScanMyTesla=Напряжение ячеек 41-60 - ScanMyTesla
Zellspannungen 61-80 - ScanMyTesla=Напряжение ячеек 61-80 - ScanMyTesla
Zellspannungen 81-99 - ScanMyTesla=Напряжение ячеек 81-99 - ScanMyTesla

Ja=да
Nein=нет

Car=Автомобиль

Automatic updates=Автоматические обновления

TextShare=<h1>Анонимно делитесь диаграммами заряда / графиками деградации </h1> Мы хотели бы создать анонимную базу данных для сравнения графиков деградации и диаграмм заряда. Это позволяет вам в любое время сравнивать свой автомобиль с другими и обнаруживать любые необычные отклонения на ранней стадии. Это также можно использовать позже, чтобы доказать во время разговора о продажах, что ваша батарея по-прежнему полностью работоспособна. В отрицательном случае вам будет легче доказать снижение производительности против Tesla Motors. <br> <br> Хотели бы вы поделиться своими диаграммами быстрой зарядки и графиками деградации с другими водителями Tesla полностью анонимно? Это решение можно изменить в любой момент на экране настроек.
StreamingPosHelp=<h1>Position by StreamingAPI</h1>enables position DB entries from the streaming API - depending on car's reception this means up to 5 positions per second (compared to one position every five seconds on normal mode), this will increase your database's size a lot, will increase wear on the SD card and result in huge backups
Daten anonym teilen=Делитесь данными анонимно
TextSuspendTeslalogger=Teslalogger остановлен! Данные не сохаряняются!
Resume Teslalogger=Включить Teslalogger
Range=Пробег

Charging Costs=Стоимость зарядок
Charger=Заряднaя станция
Currency=валюта
Cost per kWh=Стоимость за кВтч
Cost per charge=Одноразовая стоимость
Cost per minute=Стоимость за минуту зарядки
Idle cost per minute=Стоимость за минтуту блокировки зарядной станции
Total=Всего
kWh according to meter/invoice=кВтч согласно счетчику / счет
Efficiency=Эффективность

TeslaAuthApps=You can use following apps to get an access token & refresh token from Tesla server:

#wallbox.php
Wallbox=Wallbox
WallboxComment=You can connect your Teslalogger to your Wallbox to calculate the efficiency of charging or the percentage of photovoltaics used to charge your car.

#restore.php
TextRestore=Убедитесь, что вы сделали резервную копию вашего Teslalogger перед восстановлением каких-либо баз данных. Переместите папку с резервной копией из \\RASPBERRY\teslalogger\backup на жесткий диск!<br><br>Процесс восстановления может занять до 10 минут!<br><br>Ни в коем случае не прерывайте процесс восстановления! Не перезагружайте страницу! Не закрывайте эту страницу!

#journeys.php
TextJourneys=You can use journeys to combine a long trip / time and summarize all numbers. This is very useful to track the complete charge time of a long trip or to compare the consumption of summer or winter tires.
Journey=Journey
New Journey=New Journey
Journey Name=Journey Name
End=End
Please Wait=Please Wait!
Please Select Start First=Please Select Start First!

#abrp.php
ABRPTitle=Abetterrouteplanner Link
TextABRP=You can setup a link from Teslalogger to Abetterrouteplanner to avoid giving your Tesla credentials to a 3rd Party. Another benefit is to minimize the possibility to prevent the car from going to sleep if more than one service is using your credentials.
ABRP1=Create an Abetterrouteplanner account
ABRP2=Go to Settings
ABRP3=Choose your car
ABRP4=Save your car to your account
ABRP5=Give your car a name
ABRP6=Click on "Link Generic" to get a ABRP token
ABRP7=Copy the token and click "Done"
ABRP8=Insert the token in Teslalogger
ABRP9=Check if the Teslalogger is connected
ABRPYT=Check YouTube tutorial for live demo
ABRPToken=Abetterrouteplanner Token


#Missing translation elements
Setup=Setup
Enabled=Enabled
Save=Save
Set password for Teslalogger's admin panel=Set password for Teslalogger's admin panel
Name=Name
Charged=Charged
Loading=Loading
Name & Position=Name & Position
Radius=Radius
Special Flags=Special Flags
Type=Type
Home=Home
Work=Work
Copy Charging Costs=Copy Charging Costs
Don't Combine Charging Sessions=Don't Combine Charging Sessions
Set Charge Limit=Set Charge Limit
SOC=SOC
Set on arrival=Set on arrival
Set Charge Limit After Charging=Set Charge Limit After Charging
Open Charge Port=Open Charge Port
Gear=Gear
D/R → P=D/R → P
D → P=D → P
R → P=R → P
High Frequency Logging=High Frequency Logging
Minutes=Minutes
Special Count=Special Count
Special Features=Special Features
Enable Sentry Mode=Enable Sentry Mode
Disable Sentry Mode=Disable Sentry Mode
Turn HVAC off=Turn HVAC off
No sleep=No sleep
kW=kW
OK=OK
Info=Info
No=No
Yes=Yes
Cell Temp=Cell Temp
Max Charge=Max Charge
Max Discharge=Max Discharge
Cell Imbalance=Cell Imbalance
Software Update=Software Update
Journeys=Journeys
ID=ID
Start Adress=Start Adress
Target Adress=Target Adress
Consumed kWh=Consumed kWh
charged kWh=charged kWh
Drive Time [h]=Drive Time [h]
Charge Time [h]=Charge Time [h]
Distance [mi]=Distance [mi]
Distance [km]=Distance [km]
Download Logfile=Download Logfile
Lines=Lines
Housekeeping=Housekeeping
Sleep Attempt=Sleep Attempt
My Degradation=My Degradation
My Charging AVG=My Charging AVG
Fleet Degradation AVG=Fleet Degradation AVG
Fleet Charging AVG=Fleet Charging AVG
Fleet Charging MAX (Firmware)=Fleet Charging MAX (Firmware)
Fleet Charging Locations=Fleet Charging Locations
Fleet Fast Charging Map=Fleet Fast Charging Map
Supercharger Usage=Supercharger Usage
Firmware Tracker=Firmware Tracker
Changelog=Changelog
Abetterrouteplanner=Abetterrouteplanner
Please enter your dexters-web.de account credentials=Please enter your dexters-web.de account credentials
Dexter Login=Dexter Login
Dexter Password=Dexter Password
Access Token=Access Token
Refresh Token=Refresh Token
Free Supercharging=Free Supercharging
Reconnect=Reconnect
Model=Model
VIN=VIN
Free SUC=Free SUC
Edit=Edit
NEW CAR=NEW CAR
Credentials Info=Credentials Info
MyTesla=MyTesla
Teslalogger Adminpanel=Teslalogger Adminpanel
Temperature=Temperature
mile=mile
Ideal=Ideal
Rated=Rated
Share data anonymously=Share data anonymously
Sleep=Sleep
to=to
Show calc. 100% range=Show calc. 100% range
Position by StreamingAPI=Position by StreamingAPI
Wallbox Test=Wallbox Test
Host=Host
Param=Param
Test=Test
Version=Version
Utility kWh=Utility kWh
Vehicle kWh=Vehicle kWh
